campeonatoAno,fase,timeCasa,pontosTimeCasa,acertos2PtsTimeCasa,acertos3PtsTimeCasa,acertosTotaisTimeCasa,LancesLivresCertosTimeCasa,rebotesDefensivosTimeCasa,rebotesOfensivosTimeCasa,rebotesTotaisTimeCasa,assistsTimeCasa,RoubadasTimeCasa,ErrosTimeCasa,TocosTimeCasa,FaltasTimeCasa,EficienciaTimeCasa,Arremessos2PtsTimeCasa,Arremessos3PtsTimeCasa,ArremessosLLTimeCasa,ArremessosTotaisTimeCasa,timeFora,pontosTimeFora,acertos2PtsTimeFora,acertos3PtsTimeFora,acertosTotaisTimeFora,LancesLivresCertosTimeFora,rebotesDefensivosTimeFora,rebotesOfensivosTimeFora,rebotesTotaisTimeFora,assistsTimeFora,RoubadasTimeFora,ErrosTimeFora,TocosTimeFora,FaltasTimeFora,EficienciaTimeFora,Arremessos2PtsTimeFora,Arremessos3PtsTimeFora,ArremessosLLTimeFora,ArremessosTotaisTimeFora
2022/2023,1º TURNO,123 Minas,73,22,8,30,5,21,18,39,16,6,9,2,22,83,44,28,7,72,Flamengo,85,14,13,27,18,26,10,36,22,4,11,3,14,101,22,35,26,57
2022/2023,1º TURNO,Corinthians,82,26,5,31,15,24,4,28,20,7,12,4,18,95,39,20,21,59,Oscar São José Basketball,77,18,9,27,14,26,12,38,20,7,16,0,18,84,28,35,20,63
2022/2023,1º TURNO,Fortaleza B. C.,62,18,4,22,14,36,14,50,8,7,16,2,29,53,38,25,33,63,BRB/Brasília,75,20,6,26,17,34,7,41,11,6,12,0,28,73,39,24,28,63
2022/2023,1º TURNO,UNIFACISA,84,21,13,34,3,27,7,34,22,5,12,0,18,99,39,25,7,64,BRB/Brasília,71,23,6,29,7,24,8,32,17,5,11,0,16,74,33,28,15,61
2022/2023,1º TURNO,Sesi Franca,83,18,12,30,11,39,16,55,16,4,19,4,16,98,32,31,23,63,Paulistano,62,20,4,24,10,23,22,45,13,10,7,2,24,61,59,24,15,83
2022/2023,1º TURNO,Rio Claro,71,20,6,26,13,21,14,35,10,7,12,2,17,68,44,22,18,66,São Paulo,98,20,17,37,7,25,8,33,20,6,9,0,13,118,33,33,8,66
2022/2023,1º TURNO,Pato Basquete,61,14,9,23,6,24,18,42,7,10,14,1,10,56,35,35,10,70,Oscar São José Basketball,71,16,11,27,6,31,14,45,17,8,13,1,14,87,34,32,9,66
2022/2023,1º TURNO,Rio Claro,93,31,7,38,10,26,6,32,18,5,12,4,23,113,42,21,12,63,Paulistano,88,22,7,29,23,19,15,34,17,8,8,1,16,96,42,26,28,68
2022/2023,1º TURNO,UNIFACISA,90,30,6,36,12,32,8,40,24,7,19,2,20,115,43,16,18,59,Cerrado Basquete,79,17,10,27,15,18,9,27,19,9,12,0,16,79,29,34,22,63
2022/2023,1º TURNO,BRB/Brasília,68,14,6,20,22,34,10,44,14,4,12,0,23,65,35,28,32,63,Pinheiros,71,19,5,24,18,36,21,57,11,7,10,3,25,80,45,32,24,77
2022/2023,1º TURNO,Fortaleza B. C.,80,29,3,32,13,25,19,44,20,9,18,6,27,91,50,16,29,66,Cerrado Basquete,86,15,12,27,20,21,13,34,12,11,17,1,23,82,27,32,33,59
2022/2023,1º TURNO,Pinheiros,81,17,9,26,20,18,10,28,25,9,9,4,12,98,33,30,23,63,123 Minas,72,13,12,25,10,28,10,38,21,5,24,2,20,83,31,24,11,55
2022/2023,1º TURNO,Cerrado Basquete,93,11,20,31,11,26,11,37,16,8,12,2,18,97,24,52,13,76,Pinheiros,95,23,10,33,19,34,15,49,20,6,15,7,17,120,48,25,21,73
2022/2023,1º TURNO,Paulistano,76,19,9,28,11,36,8,44,24,7,23,3,18,96,36,23,15,59,Pato Basquete,69,18,8,26,9,25,7,32,10,18,14,0,17,66,38,29,17,67
2022/2023,1º TURNO,123 Minas,92,24,12,36,8,27,14,41,22,11,12,1,21,109,47,31,12,78,Sesi Franca,94,20,12,32,18,30,9,39,21,4,15,1,16,103,35,30,26,65
2022/2023,FINAL,Sesi Franca,92,27,8,35,14,34,12,46,15,12,16,4,21,112,39,32,19,71,São Paulo,68,17,9,26,7,25,8,33,19,11,17,1,20,68,42,25,13,67
2022/2023,FINAL,Sesi Franca,88,23,9,32,15,27,9,36,19,2,14,5,18,100,34,28,21,62,São Paulo,98,22,13,35,15,22,8,30,22,7,5,0,24,114,41,28,19,69
2022/2023,FINAL,São Paulo,80,17,10,27,16,29,12,41,9,6,10,2,26,84,40,28,19,68,Sesi Franca,88,18,10,28,22,30,12,42,19,4,9,7,22,109,40,26,26,66
2022/2023,SEMI,Sesi Franca,93,25,10,35,13,28,4,32,20,3,11,4,20,114,36,23,16,59,123 Minas,79,17,10,27,15,18,12,30,17,6,7,1,22,83,39,28,18,67
2022/2023,SEMI,Sesi Franca,90,21,11,32,15,27,16,43,16,1,13,1,24,95,40,31,19,71,123 Minas,93,23,9,32,20,25,6,31,21,5,11,2,23,106,38,25,24,63
2022/2023,FINAL,São Paulo,92,15,14,29,20,23,4,27,20,6,11,2,23,106,27,30,22,57,Sesi Franca,94,23,9,32,21,23,15,38,13,6,9,2,22,105,42,29,21,71
2022/2023,SEMI,123 Minas,91,22,9,31,20,29,8,37,20,4,13,0,23,99,38,24,29,62,Sesi Franca,95,19,13,32,18,22,7,29,20,4,8,2,25,102,31,34,25,65
2022/2023,1º TURNO,Flamengo,80,17,13,30,7,37,18,55,26,6,15,3,15,105,31,39,17,70,Fortaleza B. C.,60,15,7,22,9,27,14,41,6,8,11,1,19,49,41,30,16,71
2022/2023,SEMI,São Paulo,72,21,6,27,12,23,8,31,13,7,14,0,21,76,32,24,16,56,Flamengo,69,19,6,25,13,22,14,36,14,11,15,2,18,76,32,32,15,64
2022/2023,FINAL,Sesi Franca,81,10,12,22,25,28,8,36,11,5,10,5,22,87,24,33,31,57,São Paulo,86,19,11,30,15,31,13,44,15,5,11,1,25,99,38,31,17,69
2022/2023,SEMI,123 Minas,103,20,13,33,24,30,10,40,22,4,9,1,20,124,37,28,29,65,Sesi Franca,89,22,11,33,12,24,6,30,25,4,7,3,22,104,37,32,16,69
2022/2023,QUARTAS,Sesi Franca,83,19,10,29,15,25,9,34,14,6,19,1,26,88,33,25,17,58,UNIFACISA,74,18,5,23,23,20,7,27,11,11,16,0,22,71,30,22,30,52
2022/2023,SEMI,São Paulo,96,14,19,33,11,27,3,30,21,9,8,0,20,118,22,40,12,62,Flamengo,79,16,12,28,11,26,17,43,23,6,15,0,16,91,28,41,15,69
2022/2023,SEMI,Flamengo,72,8,11,19,23,24,14,38,15,7,17,1,20,77,24,31,26,55,São Paulo,80,22,7,29,15,24,7,31,17,6,13,2,27,91,31,27,18,58
2022/2023,QUARTAS,123 Minas,71,21,7,28,8,34,13,47,16,6,13,2,21,90,41,23,11,64,Paulistano,67,15,9,24,10,25,18,43,10,4,9,4,19,63,40,35,15,75
2021/2022,1º TURNO,Mogi,77,18,9,27,14,28,12,40,24,7,18,2,18,96,37,23,17,60,Paulistano,72,16,9,25,13,22,8,30,18,12,15,3,16,80,32,28,18,60
2022/2023,SEMI,Sesi Franca,112,28,13,41,17,30,8,38,22,2,2,3,15,136,41,32,24,73,123 Minas,98,16,20,36,6,27,6,33,21,2,5,0,23,112,36,36,7,72
2021/2022,1º TURNO,Bauru,77,19,8,27,15,35,5,40,13,4,17,2,16,87,27,23,24,50,Rio Claro,65,18,7,25,8,22,8,30,18,6,7,4,25,71,39,29,10,68
2021/2022,1º TURNO,Caxias do Sul Basquete,73,22,8,30,5,18,6,24,17,7,14,0,22,70,41,23,8,64,Flamengo,86,14,12,26,22,28,12,40,20,9,20,2,19,102,32,24,27,56
2021/2022,1º TURNO,Pinheiros,80,13,13,26,15,28,25,53,18,5,12,2,23,87,43,36,21,79,Sesi Franca,89,21,10,31,17,32,7,39,20,7,8,5,18,115,39,25,21,64
2021/2022,FINAL,Sesi Franca,80,18,11,29,11,35,14,49,13,9,12,1,16,98,36,34,12,70,Flamengo,65,17,7,24,10,27,13,40,14,6,10,1,15,66,30,42,12,72
2021/2022,FINAL,Flamengo,81,20,9,29,14,32,13,45,20,3,7,0,19,92,37,32,24,69,Sesi Franca,75,17,9,26,14,33,9,42,14,3,6,2,25,87,37,27,19,64
2021/2022,FINAL,Flamengo,62,12,10,22,8,31,16,47,12,8,12,1,20,64,28,40,16,68,Sesi Franca,64,11,10,21,12,31,14,45,15,5,13,4,18,71,29,33,20,62
2021/2022,SEMI,Sesi Franca,81,16,9,25,22,28,17,45,17,6,12,4,24,95,37,27,29,64,São Paulo,78,19,6,25,22,23,15,38,10,7,13,2,26,77,42,26,24,68
2021/2022,FINAL,Sesi Franca,85,14,15,29,12,33,12,45,17,2,15,3,18,98,30,37,13,67,Flamengo,79,22,8,30,11,25,11,36,15,9,10,0,16,84,41,30,15,71
2021/2022,SEMI,123 Minas,80,17,10,27,16,22,8,30,22,8,14,2,19,92,31,26,22,57,Flamengo,91,19,12,31,17,25,13,38,23,6,15,2,20,107,34,30,22,64
2021/2022,SEMI,123 Minas,63,15,5,20,18,26,7,33,15,4,12,4,25,65,34,23,23,57,Flamengo,77,14,9,23,22,29,11,40,11,8,13,0,19,83,29,28,28,57
2021/2022,SEMI,São Paulo,65,17,6,23,13,25,8,33,9,8,8,1,22,62,28,35,19,63,Sesi Franca,78,21,7,28,15,34,20,54,11,3,14,2,22,86,39,31,21,70
2021/2022,SEMI,São Paulo,87,18,14,32,9,32,10,42,18,6,13,2,22,100,38,31,14,69,Sesi Franca,74,14,9,23,19,27,9,36,16,5,10,4,18,80,31,33,23,64
2021/2022,QUARTAS,123 Minas,75,19,7,26,16,36,10,46,18,5,19,5,16,97,29,26,20,55,UNIFACISA,63,23,3,26,8,18,5,23,16,14,9,1,21,65,51,15,11,66
2021/2022,SEMI,Flamengo,76,17,9,26,15,20,12,32,19,8,13,1,21,85,33,28,18,61,123 Minas,67,16,6,22,17,22,6,28,15,5,16,4,22,73,29,20,20,49
2021/2022,SEMI,Sesi Franca,80,15,9,24,23,32,10,42,12,4,9,2,26,84,35,28,31,63,São Paulo,78,16,10,26,16,29,4,33,10,6,9,1,23,76,27,30,28,57
2021/2022,1º TURNO,Pato Basquete,73,15,11,26,10,23,8,31,16,5,14,1,20,70,24,29,25,53,Corinthians,80,11,16,27,10,23,8,31,18,5,18,1,22,81,20,36,17,56
2021/2022,1º TURNO,Caxias do Sul Basquete,75,24,6,30,9,24,11,35,9,7,9,2,19,84,40,20,14,60,123 Minas,83,14,13,27,16,22,7,29,15,6,11,2,12,90,30,26,21,56
2021/2022,1º TURNO,Pinheiros,86,22,8,30,18,33,4,37,19,7,14,3,20,102,39,22,23,61,Rio Claro,75,15,9,24,18,28,10,38,14,9,13,2,24,75,37,30,25,67
2021/2022,1º TURNO,Luvix/União Corinthians,76,21,9,30,7,27,7,34,16,9,13,3,24,80,38,26,18,64,Flamengo,87,18,10,28,21,33,17,50,10,5,15,1,18,89,39,32,27,71
2021/2022,1º TURNO,São Paulo,76,23,6,29,12,25,6,31,19,8,16,3,20,83,45,18,16,63,Cerrado Basquete,78,22,8,30,10,30,13,43,18,7,22,3,17,87,39,27,14,66
2021/2022,QUARTAS,UNIFACISA,85,24,10,34,7,24,11,35,10,5,14,3,25,82,38,30,15,68,123 Minas,88,21,10,31,16,26,9,35,10,9,16,1,21,90,36,27,21,63
2021/2022,QUARTAS,Pinheiros,79,21,10,31,7,26,11,37,20,5,10,0,17,86,43,30,10,73,Sesi Franca,91,23,12,35,9,32,2,34,24,6,13,4,20,115,29,31,15,60
2021/2022,QUARTAS,Bauru,71,19,9,28,6,24,9,33,18,7,16,2,16,76,32,30,11,62,São Paulo,88,17,15,32,9,28,7,35,20,9,14,3,13,108,27,34,13,61
2021/2022,QUARTAS,Paulistano,68,25,3,28,9,19,11,30,21,7,12,1,18,80,43,17,12,60,Flamengo,87,18,14,32,9,21,12,33,24,8,12,3,14,109,35,25,15,60
2021/2022,QUARTAS,Bauru,62,11,8,19,16,24,6,30,12,5,11,3,16,61,26,28,21,54,São Paulo,85,26,7,33,12,30,8,38,16,4,9,4,19,103,42,23,15,65
2021/2022,QUARTAS,UNIFACISA,91,21,11,32,16,33,7,40,17,7,14,3,22,111,32,26,23,58,123 Minas,80,15,10,25,20,20,13,33,12,8,10,2,17,76,38,30,26,68
2021/2022,QUARTAS,Paulistano,73,22,7,29,8,21,6,27,18,5,13,1,21,83,39,17,9,56,Flamengo,80,11,17,28,7,21,6,27,17,7,15,1,16,87,22,32,11,54
2021/2022,QUARTAS,Pinheiros,84,20,11,31,11,29,11,40,19,9,11,2,17,96,38,37,14,75,Sesi Franca,92,22,12,34,12,33,3,36,20,7,12,4,15,114,38,26,15,64
2021/2022,OITAVAS,Pinheiros,89,20,12,32,13,30,15,45,13,6,7,2,12,102,48,24,19,72,Corinthians,78,15,14,29,6,27,17,44,18,4,11,0,20,84,30,45,9,75
2021/2022,QUARTAS,Flamengo,74,14,7,21,25,29,15,44,16,2,11,1,15,82,33,26,31,59,Paulistano,68,15,11,26,5,25,11,36,15,5,10,3,26,76,41,23,8,64
2021/2022,QUARTAS,São Paulo,90,23,12,35,8,34,8,42,24,5,8,5,9,120,35,35,11,70,Bauru,65,16,10,26,3,28,6,34,13,5,10,3,17,68,33,35,3,68
2021/2022,QUARTAS,Sesi Franca,95,20,13,33,16,31,8,39,22,9,10,3,17,120,38,30,19,68,Pinheiros,86,14,14,28,16,28,19,47,13,6,13,2,17,90,37,40,18,77
2021/2022,QUARTAS,123 Minas,85,24,11,35,4,35,11,46,16,6,10,2,9,108,40,30,6,70,UNIFACISA,65,14,10,24,7,24,8,32,13,8,8,0,17,65,36,32,8,68
2021/2022,OITAVAS,Paulistano,68,13,10,23,12,13,14,27,16,5,9,4,16,74,31,28,13,59,Rio Claro,64,20,6,26,6,22,14,36,10,3,17,3,21,67,38,16,10,54
2021/2022,OITAVAS,Paulistano,90,21,9,30,21,22,9,31,19,13,5,4,21,115,38,22,28,60,Rio Claro,84,16,11,27,19,24,11,35,14,3,16,2,27,89,29,27,23,56
2021/2022,OITAVAS,Bauru,82,20,10,30,12,27,7,34,19,4,11,2,14,97,32,27,16,59,Pato Basquete,71,16,11,27,6,22,11,33,15,8,13,2,19,75,28,37,9,65
2021/2022,OITAVAS,Bauru,88,13,15,28,17,18,3,21,16,5,9,4,23,96,27,29,18,56,Pato Basquete,79,15,11,26,16,24,8,32,18,5,13,0,19,88,30,23,22,53
2021/2022,OITAVAS,UNIFACISA,81,17,13,30,8,30,16,46,17,4,8,2,16,98,36,35,11,71,Caxias do Sul Basquete,67,15,7,22,16,26,9,35,10,4,8,2,12,67,34,29,18,63
2021/2022,OITAVAS,Corinthians,78,22,9,31,7,25,12,37,20,8,17,0,21,92,39,24,9,63,Pinheiros,80,20,9,29,13,21,10,31,15,7,13,4,15,89,38,24,15,62
2021/2022,OITAVAS,Rio Claro,67,24,2,26,13,23,6,29,8,3,7,0,20,68,41,16,14,57,Paulistano,65,20,6,26,7,25,7,32,14,1,13,1,18,68,36,19,10,55
2021/2022,OITAVAS,Pato Basquete,72,16,10,26,10,33,14,47,12,6,10,2,18,80,29,41,15,70,Bauru,63,18,5,23,12,31,5,36,14,7,11,1,16,71,34,26,14,60
2021/2022,OITAVAS,Caxias do Sul Basquete,64,10,13,23,5,24,4,28,10,5,21,1,20,50,23,30,12,53,UNIFACISA,73,15,10,25,13,30,13,43,14,9,18,0,23,79,38,25,17,63
2021/2022,2º TURNO,Flamengo,113,27,18,45,5,31,13,44,34,13,7,4,13,158,39,45,9,84,BRB/Brasília,83,21,12,33,5,28,10,38,21,3,16,0,12,87,43,32,5,75
2021/2022,2º TURNO,Pinheiros,92,24,12,36,8,32,12,44,19,10,11,1,20,112,40,36,11,76,Flamengo,80,12,15,27,11,31,8,39,19,3,15,1,18,85,27,38,15,65
2021/2022,2º TURNO,Caxias do Sul Basquete,57,15,7,22,6,24,10,34,14,4,13,1,20,58,31,26,10,57,Corinthians,62,12,9,21,11,24,13,37,14,5,14,2,15,65,28,28,17,56
2021/2022,2º TURNO,São Paulo,66,19,3,22,19,38,3,41,11,4,16,4,24,70,39,17,25,56,Sesi Franca,81,19,11,30,10,34,13,47,16,8,10,1,23,89,45,34,15,79
2021/2022,2º TURNO,Fortaleza B. C.,77,22,8,30,9,25,6,31,11,10,15,3,17,82,31,23,20,54,BRB/Brasília,65,15,9,24,8,24,9,33,12,5,17,1,18,62,32,24,13,56
2021/2022,2º TURNO,UNIFACISA,75,19,10,29,7,28,12,40,14,6,10,1,17,83,40,28,11,68,Cerrado Basquete,65,16,9,25,6,29,11,40,8,4,17,1,17,60,35,25,12,60
2021/2022,2º TURNO,Luvix/União Corinthians,55,15,6,21,7,20,4,24,9,4,11,1,20,39,31,25,15,56,Corinthians,74,19,7,26,15,34,14,48,8,6,18,0,18,83,34,26,16,60
2021/2022,2º TURNO,Caxias do Sul Basquete,61,17,7,24,6,26,7,33,18,14,17,3,19,74,38,23,7,61,Paulistano,54,17,4,21,8,29,13,42,10,6,24,0,16,46,36,21,14,57
2021/2022,2º TURNO,Pinheiros,83,23,10,33,7,24,11,35,17,9,15,5,20,97,42,25,10,67,123 Minas,93,21,11,32,18,24,11,35,18,10,11,2,16,110,35,31,21,66
2021/2022,2º TURNO,Corinthians,75,18,12,30,3,24,18,42,18,7,12,0,14,86,42,31,4,73,Bauru,67,18,7,25,10,24,4,28,16,7,15,1,13,72,28,22,17,50
2021/2022,2º TURNO,Fortaleza B. C.,75,24,7,31,6,33,11,44,14,14,16,5,21,89,51,22,11,73,Cerrado Basquete,77,23,7,30,10,34,9,43,13,11,19,5,12,86,47,19,18,66
2021/2022,2º TURNO,São Paulo,96,22,13,35,13,32,3,35,21,5,14,3,18,120,29,27,18,56,Rio Claro,69,20,7,27,8,21,14,35,13,6,14,1,20,61,47,23,14,70
2021/2022,2º TURNO,UNIFACISA,72,20,7,27,11,18,10,28,10,13,11,1,16,69,40,28,14,68,BRB/Brasília,90,16,17,33,7,30,6,36,22,7,20,1,14,109,29,26,12,55
2021/2022,2º TURNO,Bauru,80,13,14,27,12,19,12,31,18,5,8,0,23,80,33,35,17,68,Flamengo,92,19,13,32,15,31,20,51,24,7,10,3,20,122,27,42,23,69
2021/2022,2º TURNO,Rio Claro,83,24,8,32,11,20,9,29,22,5,12,1,24,99,39,19,14,58,UNIFACISA,72,18,7,25,15,17,16,33,12,3,14,0,19,66,35,26,19,61
2021/2022,2º TURNO,Luvix/União Corinthians,71,18,7,25,14,25,13,38,15,6,17,2,27,68,40,29,17,69,Paulistano,88,18,10,28,22,33,5,38,9,7,17,1,21,94,29,27,26,56
2021/2022,2º TURNO,Bauru,101,22,16,38,9,28,6,34,25,9,12,1,21,129,37,29,10,66,123 Minas,69,16,7,23,16,21,7,28,11,7,18,3,14,65,32,24,18,56
2021/2022,2º TURNO,Pinheiros,69,13,12,25,7,20,10,30,19,15,13,3,16,71,38,36,10,74,Mogi,90,20,13,33,11,39,13,52,27,10,23,3,15,122,34,33,14,67
2021/2022,2º TURNO,Cerrado Basquete,86,25,7,32,15,38,14,52,19,5,11,6,20,101,55,26,22,81,BRB/Brasília,90,21,11,32,15,37,16,53,14,7,10,3,21,99,47,35,23,82
2021/2022,2º TURNO,Pato Basquete,59,15,6,21,11,30,8,38,10,6,18,0,19,52,32,26,17,58,Caxias do Sul Basquete,68,19,7,26,9,30,8,38,13,4,16,1,19,66,34,27,16,61
2021/2022,2º TURNO,Sesi Franca,90,29,8,37,8,35,11,46,22,7,15,2,17,114,44,24,15,68,Fortaleza B. C.,66,21,5,26,9,23,9,32,14,9,17,1,17,56,39,27,18,66
2021/2022,2º TURNO,Mogi,86,23,10,33,10,36,9,45,27,8,26,5,15,118,37,20,13,57,Caxias do Sul Basquete,65,19,7,26,6,16,8,24,15,11,14,2,18,53,34,36,12,70
2021/2022,2º TURNO,Rio Claro,82,20,9,29,15,27,11,38,14,8,12,5,23,95,37,29,18,66,Fortaleza B. C.,66,19,6,25,10,26,10,36,18,7,15,6,21,75,32,28,18,60
2021/2022,2º TURNO,Sesi Franca,74,16,9,25,15,30,5,35,19,3,9,3,16,89,26,31,19,57,UNIFACISA,65,9,13,22,8,29,15,44,11,3,11,0,18,61,29,37,15,66
2021/2022,2º TURNO,Pato Basquete,90,26,5,31,23,30,5,35,13,12,13,0,17,92,44,26,29,70,Luvix/União Corinthians,89,17,15,32,10,36,5,41,16,7,23,2,25,94,32,34,14,66
2021/2022,2º TURNO,BRB/Brasília,60,19,5,24,7,27,6,33,9,5,10,2,15,54,44,23,9,67,Paulistano,78,21,8,29,12,37,12,49,14,7,12,1,13,97,43,22,16,65
2021/2022,2º TURNO,Corinthians,79,19,11,30,8,25,13,38,15,0,14,3,21,80,34,34,11,68,Pinheiros,83,24,9,33,8,25,13,38,20,7,13,0,13,95,46,21,14,67
2021/2022,2º TURNO,Mogi,85,22,13,35,2,33,7,40,25,7,13,3,14,105,42,29,8,71,Luvix/União Corinthians,75,21,7,28,12,28,14,42,20,8,10,5,19,93,44,29,14,73
2021/2022,2º TURNO,Pinheiros,82,24,8,32,10,32,18,50,23,6,14,6,18,105,52,25,13,77,Pato Basquete,69,14,11,25,8,26,16,42,12,3,17,3,14,64,35,38,8,73
2021/2022,2º TURNO,Cerrado Basquete,76,17,7,24,21,32,14,46,11,3,14,3,22,78,43,21,28,64,Paulistano,80,25,4,29,18,29,12,41,13,9,5,2,22,93,45,25,24,70
2021/2022,2º TURNO,Flamengo,88,11,15,26,21,25,13,38,11,5,10,0,20,88,25,41,25,66,São Paulo,78,17,10,27,14,28,6,34,13,3,16,1,23,78,28,29,19,57
2021/2022,2º TURNO,123 Minas,61,15,8,23,7,24,12,36,12,4,15,2,17,58,38,26,8,64,São Paulo,82,25,8,33,8,28,10,38,25,6,8,5,14,111,36,28,14,64
2021/2022,2º TURNO,Fortaleza B. C.,91,23,11,34,12,26,10,36,14,5,12,2,22,99,36,29,18,65,Flamengo,94,21,11,32,19,23,18,41,16,6,8,3,19,107,37,37,22,74
2021/2022,2º TURNO,BRB/Brasília,96,14,17,31,17,32,7,39,14,4,8,2,21,107,26,39,23,65,Sesi Franca,86,23,8,31,16,27,9,36,17,4,6,2,23,96,45,26,19,71
2021/2022,2º TURNO,São Paulo,88,23,10,33,12,26,19,45,24,6,8,2,14,115,43,29,15,72,Corinthians,67,20,7,27,6,22,9,31,17,3,12,0,17,69,38,26,6,64
2021/2022,2º TURNO,Bauru,84,24,8,32,12,27,11,38,12,7,17,1,21,85,44,25,15,69,Pato Basquete,74,19,7,26,15,25,10,35,9,5,21,2,21,64,34,28,19,62
2021/2022,2º TURNO,Luvix/União Corinthians,84,23,5,28,23,26,14,40,13,8,10,2,19,89,45,19,35,64,Caxias do Sul Basquete,70,16,9,25,11,28,3,31,9,7,15,0,28,68,33,20,17,53
2021/2022,2º TURNO,Cerrado Basquete,73,21,6,27,13,29,12,41,16,1,9,5,21,82,40,23,22,63,Rio Claro,79,18,7,25,22,28,17,45,15,4,6,2,23,91,41,26,28,67
2021/2022,2º TURNO,UNIFACISA,74,21,7,28,11,36,12,48,13,9,17,1,18,88,39,23,17,62,Flamengo,60,8,11,19,11,23,10,33,9,9,17,0,21,42,17,46,19,63
2021/2022,2º TURNO,Fortaleza B. C.,75,20,7,27,14,21,6,27,7,6,7,0,25,63,32,35,19,67,123 Minas,85,16,10,26,23,33,11,44,15,4,17,2,21,98,27,28,29,55
2021/2022,2º TURNO,BRB/Brasília,79,22,9,31,8,27,12,39,13,7,10,0,20,85,38,32,12,70,Rio Claro,80,15,9,24,23,28,10,38,9,8,13,2,19,86,36,24,25,60
2021/2022,2º TURNO,Cerrado Basquete,88,18,13,31,13,30,8,38,17,6,11,2,20,102,34,32,16,66,Sesi Franca,89,23,10,33,13,28,13,41,16,6,11,4,14,100,43,31,17,74
2021/2022,2º TURNO,UNIFACISA,70,23,6,29,6,24,9,33,15,9,12,1,17,81,37,25,8,62,123 Minas,59,17,6,23,7,25,11,36,10,7,16,0,16,57,30,27,12,57
2021/2022,2º TURNO,Paulistano,93,24,14,38,3,25,16,41,21,6,11,1,20,110,43,31,8,74,Pinheiros,82,16,10,26,20,21,9,30,19,6,13,0,12,88,34,24,24,58
2021/2022,2º TURNO,Bauru,107,19,17,36,18,34,7,41,21,13,12,2,24,128,40,39,19,79,Mogi,103,18,15,33,22,37,9,46,23,5,20,3,21,117,33,41,24,74
2021/2022,2º TURNO,Pato Basquete,62,19,2,21,18,29,11,40,9,6,17,1,17,59,35,24,22,59,São Paulo,82,24,7,31,13,28,4,32,8,7,10,1,18,87,36,28,13,64
2021/2022,2º TURNO,Flamengo,117,24,17,41,18,46,13,59,34,5,7,2,13,168,37,42,22,79,Luvix/União Corinthians,55,11,9,20,6,26,9,35,15,4,11,2,21,43,43,32,8,75
2021/2022,2º TURNO,Flamengo,76,15,13,28,7,26,11,37,14,4,12,6,16,88,26,36,10,62,Corinthians,71,18,10,28,5,22,6,28,19,2,13,1,18,73,32,26,10,58
2021/2022,2º TURNO,Flamengo,73,7,16,23,11,27,16,43,18,7,13,5,14,90,22,44,11,66,Paulistano,70,22,8,30,2,26,11,37,14,10,9,4,18,85,45,25,3,70
2021/2022,2º TURNO,Mogi,73,18,10,28,7,27,10,37,16,4,20,3,20,74,33,30,11,63,São Paulo,90,17,15,32,11,27,4,31,17,11,12,2,19,103,27,33,19,60
2021/2022,2º TURNO,Paulistano,87,27,6,33,15,27,10,37,22,6,10,2,17,109,39,24,20,63,Sesi Franca,77,25,6,31,9,22,13,35,16,7,9,1,17,84,49,23,11,72
2021/2022,2º TURNO,Luvix/União Corinthians,83,18,12,30,11,27,11,38,17,9,11,3,23,90,34,34,22,68,Pinheiros,87,20,10,30,17,32,9,41,13,4,15,1,21,95,38,25,20,63
2021/2022,2º TURNO,Caxias do Sul Basquete,60,15,8,23,6,29,9,38,15,3,10,2,19,67,30,31,9,61,Bauru,66,16,8,24,10,31,9,40,10,7,12,1,16,74,31,26,15,57
2021/2022,2º TURNO,Luvix/União Corinthians,77,21,8,29,11,31,12,43,13,5,11,1,18,83,37,31,17,68,Bauru,82,12,15,27,13,27,10,37,11,6,8,0,20,84,25,42,17,67
2021/2022,2º TURNO,Corinthians,69,17,8,25,11,30,12,42,14,5,19,2,18,73,36,23,17,59,UNIFACISA,70,17,7,24,15,25,8,33,17,12,10,2,18,83,35,25,20,60
2021/2022,2º TURNO,Paulistano,83,14,15,29,10,29,13,42,18,7,15,0,15,95,34,30,15,64,UNIFACISA,64,14,9,23,9,23,10,33,12,7,16,2,20,62,33,29,10,62
2021/2022,2º TURNO,Corinthians,81,15,13,28,12,35,13,48,18,7,20,7,18,101,28,34,18,62,Fortaleza B. C.,65,23,5,28,4,23,10,33,17,9,11,4,17,64,46,22,17,68
2021/2022,2º TURNO,Caxias do Sul Basquete,80,13,14,27,12,21,9,30,17,7,17,1,22,81,29,29,18,58,Pinheiros,87,25,6,31,19,23,8,31,17,9,15,5,18,101,39,17,27,56
2021/2022,2º TURNO,Pato Basquete,79,19,10,29,11,29,9,38,16,11,9,1,21,86,34,36,20,70,Mogi,70,14,11,25,9,33,9,42,18,4,19,1,19,75,30,31,14,61
2021/2022,2º TURNO,123 Minas,95,22,13,35,12,23,4,27,26,3,13,2,16,115,28,28,16,56,BRB/Brasília,82,23,9,32,9,19,15,34,13,8,12,1,16,83,41,27,16,68
2021/2022,2º TURNO,Rio Claro,78,19,9,28,13,27,8,35,19,5,13,1,18,85,36,30,15,66,Sesi Franca,102,30,9,39,15,32,5,37,20,8,6,0,21,127,41,26,21,67
2021/2022,2º TURNO,Paulistano,94,18,14,32,16,21,9,30,18,6,13,6,28,101,36,33,19,69,Fortaleza B. C.,88,25,7,32,17,28,19,47,22,5,20,2,20,99,49,21,24,70
2021/2022,2º TURNO,Sesi Franca,90,16,13,29,19,27,14,41,13,6,6,0,20,97,33,36,26,69,Flamengo,85,18,14,32,7,28,6,34,15,2,10,4,25,95,26,37,11,63
2021/2022,2º TURNO,123 Minas,74,27,2,29,14,32,12,44,12,5,14,2,19,87,45,19,15,64,Cerrado Basquete,66,17,6,23,14,22,13,35,16,8,9,4,16,71,32,31,23,63
2021/2022,2º TURNO,BRB/Brasília,89,19,8,27,27,24,5,29,16,5,16,1,30,92,30,18,38,48,Corinthians,91,15,11,26,28,22,11,33,13,7,12,2,30,93,33,23,39,56
2021/2022,2º TURNO,São Paulo,80,17,9,26,19,29,11,40,15,8,13,1,19,91,31,30,24,61,Paulistano,71,17,8,25,13,23,11,34,10,7,13,3,23,67,41,24,18,65
2021/2022,2º TURNO,Rio Claro,79,20,8,28,15,21,10,31,10,3,8,0,17,76,46,18,18,64,Flamengo,99,15,19,34,12,27,14,41,18,4,9,4,17,120,24,43,16,67
2021/2022,2º TURNO,Cerrado Basquete,86,23,12,35,4,30,8,38,19,3,6,2,15,105,38,30,8,68,Corinthians,80,15,15,30,5,29,14,43,18,4,8,4,16,96,37,36,7,73
2021/2022,2º TURNO,Pinheiros,60,22,2,24,10,30,21,51,13,2,12,2,13,60,42,31,17,73,Bauru,65,15,9,24,8,30,6,36,14,5,11,1,15,74,29,31,8,60
2021/2022,2º TURNO,Rio Claro,75,20,10,30,5,18,13,31,16,7,10,0,19,79,32,31,12,63,123 Minas,78,11,12,23,20,23,8,31,16,3,14,1,17,86,20,30,22,50
2021/2022,2º TURNO,Fortaleza B. C.,82,22,9,31,11,22,9,31,13,16,9,4,18,93,45,25,16,70,Mogi,75,20,8,28,11,30,9,39,20,4,22,4,18,85,35,22,17,57
2021/2022,2º TURNO,São Paulo,98,21,10,31,26,40,10,50,22,6,9,5,19,131,29,33,36,62,Luvix/União Corinthians,71,22,5,27,12,24,10,34,19,7,8,2,23,72,43,32,17,75
2021/2022,2º TURNO,UNIFACISA,87,17,14,31,11,28,5,33,19,9,13,5,20,109,25,35,13,60,Pato Basquete,78,19,10,29,10,25,11,36,16,9,14,0,17,84,39,26,15,65
2021/2022,2º TURNO,Paulistano,53,11,7,18,10,29,13,42,10,3,21,2,14,46,27,30,14,57,Bauru,65,15,10,25,5,25,5,30,15,15,15,1,17,74,30,27,10,57
2021/2022,2º TURNO,Sesi Franca,98,20,13,33,19,24,11,35,16,1,12,3,22,109,28,32,24,60,123 Minas,89,21,9,30,20,17,8,25,12,7,8,1,24,91,36,25,24,61
2021/2022,2º TURNO,Fortaleza B. C.,78,18,7,25,21,28,12,40,10,6,16,2,21,76,38,22,30,60,Pato Basquete,84,20,10,30,14,23,9,32,13,9,15,3,28,88,32,31,19,63
2021/2022,2º TURNO,Flamengo,69,19,7,26,10,31,10,41,17,6,8,5,17,80,41,30,15,71,Cerrado Basquete,63,23,2,25,11,35,11,46,12,4,15,2,18,69,45,19,15,64
2021/2022,2º TURNO,UNIFACISA,91,16,16,32,11,27,15,42,19,12,18,4,22,104,45,32,12,77,Mogi,82,20,9,29,15,30,6,36,18,8,19,7,16,96,33,27,20,60
2021/2022,2º TURNO,Luvix/União Corinthians,80,18,11,29,11,28,12,40,13,3,14,4,24,81,37,32,16,69,Fortaleza B. C.,86,19,11,30,15,30,11,41,15,8,11,0,19,93,39,26,26,65
2021/2022,2º TURNO,São Paulo,93,24,9,33,18,35,9,44,24,9,9,2,19,126,40,23,25,63,Caxias do Sul Basquete,53,12,5,17,14,25,12,37,13,7,15,2,20,45,32,28,23,60
2021/2022,2º TURNO,Caxias do Sul Basquete,60,15,7,22,9,23,9,32,14,9,14,1,19,60,37,24,12,61,UNIFACISA,79,20,8,28,15,31,7,38,15,7,17,3,18,93,32,24,19,56
2021/2022,2º TURNO,Paulistano,86,17,8,25,28,18,5,23,12,11,10,2,31,87,33,23,34,56,Rio Claro,78,18,6,24,24,27,14,41,12,4,21,2,26,75,39,13,37,52
2021/2022,2º TURNO,123 Minas,88,18,13,31,13,29,12,41,20,6,14,4,23,107,34,32,16,66,Flamengo,79,12,13,25,16,24,8,32,16,5,14,4,16,83,24,37,19,61
2021/2022,2º TURNO,Mogi,83,20,9,29,16,32,8,40,26,7,14,2,21,102,36,30,21,66,BRB/Brasília,72,18,7,25,15,32,9,41,15,6,15,2,21,78,35,30,18,65
2021/2022,2º TURNO,Pato Basquete,78,13,12,25,16,16,11,27,12,8,9,0,24,71,39,27,20,66,Cerrado Basquete,94,21,8,29,28,32,15,47,11,2,14,1,17,107,33,28,30,61
2021/2022,2º TURNO,Corinthians,65,21,7,28,2,31,11,42,18,1,14,1,15,71,38,31,3,69,Sesi Franca,81,27,7,34,6,28,11,39,19,6,4,0,10,98,44,31,8,75
2021/2022,2º TURNO,Luvix/União Corinthians,70,17,11,28,3,23,9,32,17,5,15,3,22,75,32,30,6,62,UNIFACISA,74,15,11,26,11,26,7,33,8,6,17,2,14,74,25,28,16,53
2021/2022,2º TURNO,Caxias do Sul Basquete,74,23,6,29,10,31,10,41,18,6,17,5,23,89,43,23,11,66,Fortaleza B. C.,66,15,6,21,18,26,14,40,14,8,12,1,17,60,42,21,33,63
2021/2022,2º TURNO,Mogi,87,26,7,33,14,39,10,49,25,7,15,3,19,119,45,22,17,67,Cerrado Basquete,67,17,6,23,15,26,14,40,16,6,10,4,15,67,50,23,21,73
2021/2022,2º TURNO,Bauru,102,20,13,33,23,24,8,32,23,7,10,2,24,125,31,30,26,61,São Paulo,87,15,13,28,18,20,4,24,16,6,10,3,25,93,24,30,25,54
2021/2022,2º TURNO,Corinthians,84,21,9,30,15,34,17,51,15,6,16,3,20,98,46,27,17,73,Rio Claro,78,24,7,31,9,27,9,36,17,8,11,4,21,83,52,22,15,74
2021/2022,2º TURNO,Pato Basquete,77,18,11,29,8,20,7,27,14,6,13,0,23,75,33,29,11,62,BRB/Brasília,75,19,7,26,16,25,13,38,11,7,19,1,17,73,36,20,26,56
2021/2022,2º TURNO,Pinheiros,92,20,15,35,7,26,16,42,19,5,9,2,14,100,45,36,12,81,São Paulo,98,23,13,36,13,31,4,35,26,6,11,5,17,129,39,26,14,65
2021/2022,2º TURNO,123 Minas,104,26,13,39,13,33,10,43,23,6,14,4,16,135,39,29,15,68,Paulistano,67,19,6,25,11,20,9,29,15,8,13,0,19,61,41,26,14,67
2021/2022,2º TURNO,Sesi Franca,92,23,10,33,16,33,8,41,18,5,7,2,13,115,43,25,17,68,Mogi,71,17,11,28,4,27,8,35,15,2,13,3,21,70,35,35,5,70
2021/2022,2º TURNO,Fortaleza B. C.,74,17,9,26,13,31,7,38,12,6,17,2,16,81,30,24,19,54,Bauru,72,16,10,26,10,21,7,28,16,6,10,2,18,75,38,27,10,65
2021/2022,2º TURNO,123 Minas,91,25,10,35,11,24,14,38,20,7,11,5,17,109,41,29,17,70,Corinthians,88,21,11,32,13,23,18,41,18,1,14,1,20,93,44,28,15,72
2021/2022,2º TURNO,Sesi Franca,97,21,12,33,19,27,8,35,17,5,16,3,15,116,27,27,23,54,Pato Basquete,80,20,11,31,7,17,9,26,21,11,9,1,19,90,33,36,9,69
2021/2022,2º TURNO,Rio Claro,75,22,5,27,16,28,17,45,14,7,11,2,20,91,43,22,19,65,Mogi,56,15,6,21,8,23,9,32,9,8,15,1,21,50,30,27,13,57
2021/2022,2º TURNO,UNIFACISA,87,18,11,29,18,23,8,31,10,4,8,1,20,88,28,32,24,60,Pinheiros,85,20,10,30,15,23,11,34,16,3,10,2,23,91,34,29,21,63
2021/2022,2º TURNO,Cerrado Basquete,55,18,2,20,13,29,17,46,6,7,10,2,14,47,39,31,22,70,Luvix/União Corinthians,73,15,9,24,16,34,11,45,16,8,13,0,22,87,44,19,19,63
2021/2022,2º TURNO,Fortaleza B. C.,65,14,9,23,10,22,3,25,11,10,14,1,16,58,26,33,14,59,Pinheiros,81,23,10,33,5,35,17,52,17,6,19,1,14,96,39,32,9,71
2021/2022,2º TURNO,UNIFACISA,92,18,15,33,11,35,8,43,17,12,8,1,22,119,30,39,13,69,Bauru,64,17,6,23,12,28,6,34,11,4,17,1,12,53,31,27,21,58
2021/2022,2º TURNO,Rio Claro,79,20,8,28,15,24,6,30,14,8,15,2,22,88,37,19,17,56,Pato Basquete,65,13,10,23,9,23,7,30,10,2,19,1,20,55,30,23,13,53
2020/2021,FINAL,São Paulo,85,22,10,32,11,31,7,38,19,1,10,3,16,100,36,29,14,65,Flamengo,93,19,14,33,13,27,7,34,22,6,3,1,17,115,34,37,13,71
2021/2022,2º TURNO,Cerrado Basquete,79,20,9,29,12,35,17,52,15,5,15,5,16,98,42,26,16,68,Caxias do Sul Basquete,61,22,4,26,5,22,7,29,19,4,10,4,20,63,45,19,11,64
2020/2021,FINAL,São Paulo,81,24,5,29,18,30,8,38,15,4,10,3,15,91,44,19,24,63,Flamengo,82,14,15,29,9,28,12,40,16,4,11,1,25,87,29,41,13,70
2020/2021,SEMI,São Paulo,80,16,12,28,12,26,10,36,18,5,6,1,19,92,32,34,16,66,Minas,79,14,12,26,15,27,4,31,17,2,8,0,21,88,27,29,18,56
2020/2021,FINAL,Flamengo,96,19,16,35,10,26,17,43,19,3,6,3,16,113,29,48,13,77,São Paulo,93,21,13,34,12,27,11,38,18,2,7,2,14,106,40,32,14,72
2020/2021,SEMI,Paulistano,58,18,6,24,4,32,17,49,12,4,6,3,18,62,51,31,4,82,Flamengo,69,21,5,26,12,41,13,54,23,4,9,2,12,95,35,37,14,72
2020/2021,SEMI,Paulistano,75,21,7,28,12,26,10,36,17,8,11,3,25,84,48,21,15,69,Flamengo,81,24,5,29,18,33,9,42,13,6,13,0,20,88,40,24,24,64
2020/2021,SEMI,São Paulo,90,17,13,30,17,25,11,36,14,6,7,4,19,101,31,34,24,65,Minas,85,20,11,31,12,27,6,33,14,3,7,1,25,97,32,31,12,63
2021/2022,2º TURNO,BRB/Brasília,92,26,9,35,13,39,9,48,25,8,18,3,20,126,36,27,17,63,Luvix/União Corinthians,71,15,10,25,11,21,10,31,18,11,14,3,22,67,39,33,17,72
2020/2021,SEMI,Flamengo,92,21,11,32,17,33,12,45,21,6,9,2,24,113,37,29,27,66,Paulistano,69,15,7,22,18,26,13,39,11,4,11,0,25,62,39,26,25,65
2021/2022,2º TURNO,BRB/Brasília,78,18,10,28,12,29,16,45,17,2,11,3,20,89,44,26,15,70,Caxias do Sul Basquete,79,20,8,28,15,26,6,32,22,6,9,5,16,98,43,18,19,61
2021/2022,2º TURNO,Mogi,70,17,8,25,12,24,14,38,21,5,16,2,17,75,35,30,17,65,123 Minas,73,25,4,29,11,29,6,35,15,9,14,1,20,86,36,22,15,58
2021/2022,2º TURNO,São Paulo,73,9,10,19,25,29,13,42,13,6,13,5,17,85,28,26,31,54,Fortaleza B. C.,62,18,6,24,8,24,16,40,9,8,14,4,23,62,42,26,11,68
2021/2022,2º TURNO,Luvix/União Corinthians,89,26,6,32,19,25,21,46,16,3,10,0,26,93,56,19,27,75,Sesi Franca,85,23,5,28,24,23,9,32,6,4,10,5,22,86,34,26,28,60
2021/2022,2º TURNO,Pato Basquete,70,13,10,23,14,23,9,32,7,2,8,1,23,62,32,30,17,62,123 Minas,101,20,16,36,13,33,7,40,16,5,6,1,17,124,34,29,19,63
2021/2022,2º TURNO,São Paulo,88,23,9,32,15,26,4,30,13,10,12,2,17,99,35,23,21,58,UNIFACISA,70,18,8,26,10,26,7,33,15,6,16,1,19,71,36,22,16,58
2020/2021,SEMI,Minas,70,24,3,27,13,23,8,31,17,5,12,1,12,71,38,24,19,62,São Paulo,88,15,18,33,4,29,14,43,18,6,15,5,17,106,25,45,6,70
2021/2022,2º TURNO,Corinthians,81,21,10,31,9,24,14,38,18,5,11,1,14,96,44,19,13,63,Paulistano,71,21,8,29,5,20,9,29,16,4,9,2,16,77,41,21,8,62
2021/2022,2º TURNO,Mogi,77,21,9,30,8,16,16,32,20,12,12,1,21,72,43,39,14,82,Flamengo,117,21,19,40,18,34,8,42,29,7,21,4,15,151,28,34,23,62
2021/2022,2º TURNO,Bauru,74,22,6,28,12,38,8,46,18,3,9,3,12,91,44,21,19,65,Cerrado Basquete,68,22,7,29,3,31,11,42,13,6,6,3,17,77,45,33,3,78
2021/2022,2º TURNO,Caxias do Sul Basquete,68,15,11,26,5,21,9,30,12,7,16,1,22,63,36,25,9,61,Sesi Franca,83,16,12,28,15,26,9,35,20,4,12,1,13,99,28,29,18,57
2021/2022,2º TURNO,Luvix/União Corinthians,84,23,5,28,23,27,17,44,12,2,10,1,28,83,42,20,39,62,Rio Claro,75,15,8,23,21,26,7,33,14,3,14,1,34,74,25,29,28,54
2021/2022,2º TURNO,Pato Basquete,87,15,17,32,6,23,6,29,15,7,11,1,23,92,28,38,8,66,Flamengo,93,20,11,31,20,28,6,34,16,3,12,0,14,104,33,28,20,61
2021/2022,2º TURNO,Pinheiros,88,20,13,33,9,32,15,47,20,15,14,2,14,111,44,32,13,76,Cerrado Basquete,70,15,10,25,10,30,7,37,14,9,18,2,17,73,32,31,13,63
2021/2022,2º TURNO,Bauru,96,22,15,37,7,21,17,38,22,6,10,2,25,114,36,38,10,74,BRB/Brasília,74,19,4,23,24,22,12,34,16,6,16,2,14,75,32,20,36,52
2020/2021,QUARTAS,Paulistano,77,18,10,28,11,22,14,36,14,4,7,1,19,79,35,32,18,67,Bauru,87,23,10,33,11,30,5,35,22,6,8,3,18,118,36,24,11,60
2021/2022,2º TURNO,Pinheiros,107,18,16,34,23,27,15,42,19,15,18,4,25,119,40,38,29,78,BRB/Brasília,95,26,9,35,16,29,19,48,17,10,25,2,28,95,47,29,27,76
2021/2022,2º TURNO,Caxias do Sul Basquete,85,18,9,27,22,26,7,33,16,3,10,5,19,94,32,25,30,57,Rio Claro,77,16,9,25,18,26,9,35,15,5,15,0,26,79,35,27,19,62
2020/2021,QUARTAS,Minas,93,15,16,31,15,33,8,41,20,4,16,0,23,116,21,33,18,54,Sesi Franca,68,23,4,27,10,16,9,25,19,8,9,1,21,66,43,23,17,66
2020/2021,QUARTAS,São Paulo,79,19,9,28,14,34,15,49,14,8,12,4,14,101,38,30,15,68,Corinthians,68,16,11,27,3,24,8,32,15,2,10,1,18,66,35,33,4,68
2020/2021,QUARTAS,Paulistano,78,19,8,27,16,28,8,36,17,7,4,2,18,93,46,22,18,68,Bauru,65,18,5,23,14,31,11,42,11,2,12,0,20,68,37,25,15,62
2021/2022,2º TURNO,Sesi Franca,104,17,19,36,13,28,10,38,20,3,8,2,16,128,23,39,18,62,Bauru,88,16,14,30,14,16,13,29,14,3,5,0,19,87,31,37,18,68
2020/2021,QUARTAS,Minas,72,14,11,25,11,29,14,43,15,4,21,5,21,77,29,31,17,60,Sesi Franca,82,17,13,30,9,24,9,33,23,11,10,2,18,100,38,28,14,66
2020/2021,QUARTAS,Flamengo,77,19,11,30,6,32,6,38,17,9,14,1,11,90,37,29,8,66,Mogi,67,20,7,27,6,32,14,46,14,8,17,4,19,76,43,29,7,72
2020/2021,QUARTAS,Sesi Franca,85,19,10,29,17,22,11,33,20,11,15,2,23,94,36,28,24,64,Minas,91,22,11,33,14,27,6,33,20,10,18,2,21,103,41,18,23,59
2020/2021,QUARTAS,Corinthians,71,17,10,27,7,22,13,35,14,8,12,1,21,68,38,35,10,73,São Paulo,78,17,9,26,17,32,13,45,17,7,18,2,14,92,30,30,22,60
2020/2021,QUARTAS,Bauru,66,15,7,22,15,27,8,35,15,4,15,0,18,70,32,21,19,53,Paulistano,78,18,12,30,6,25,13,38,14,8,8,2,19,89,36,28,15,64
2021/2022,2º TURNO,123 Minas,97,19,16,35,11,33,7,40,19,7,20,6,20,110,32,31,22,63,Luvix/União Corinthians,82,20,8,28,18,25,8,33,17,13,13,5,20,90,44,26,23,70
2021/2022,2º TURNO,Paulistano,69,20,6,26,11,28,11,39,12,10,16,4,19,75,39,24,17,63,Mogi,62,18,6,24,8,29,7,36,18,5,21,0,19,61,33,24,14,57
2021/2022,2º TURNO,Cerrado Basquete,86,22,11,33,9,18,14,32,19,4,11,2,19,92,37,35,10,72,São Paulo,84,17,13,30,11,24,13,37,17,3,16,3,16,91,28,33,17,61
2021/2022,2º TURNO,Corinthians,58,14,7,21,9,33,7,40,16,6,11,3,18,63,32,31,16,63,Pato Basquete,60,15,8,23,6,36,14,50,13,7,12,2,16,72,40,29,8,69
2021/2022,2º TURNO,Sesi Franca,95,18,15,33,14,25,15,40,20,10,19,4,13,112,30,39,16,69,Pinheiros,80,22,7,29,15,23,5,28,18,13,17,3,10,91,38,23,17,61
2021/2022,2º TURNO,123 Minas,83,24,9,33,8,35,11,46,19,10,14,3,13,111,39,27,11,66,Caxias do Sul Basquete,62,21,4,25,8,22,9,31,17,6,13,4,19,62,46,20,12,66
2021/2022,2º TURNO,Rio Claro,76,27,3,30,13,20,20,40,7,7,16,2,24,70,45,26,18,71,Bauru,84,15,12,27,18,22,4,26,16,10,16,0,22,92,27,21,25,48
2021/2022,2º TURNO,UNIFACISA,95,12,20,32,11,31,7,38,21,4,11,3,20,113,27,38,15,65,Fortaleza B. C.,68,19,8,27,6,28,7,35,14,3,11,3,18,71,38,24,12,62
2020/2021,OITAVAS,Mogi,94,23,8,31,24,34,7,41,24,6,12,2,20,122,36,24,28,60,UNIFACISA,85,12,16,28,13,23,18,41,17,7,9,0,27,86,41,38,17,79
2021/2022,2º TURNO,Flamengo,90,18,16,34,6,39,13,52,30,10,16,1,9,125,34,38,10,72,Caxias do Sul Basquete,55,14,8,22,3,27,3,30,11,7,15,2,19,46,38,27,4,65
2020/2021,OITAVAS,Sesi Franca,82,24,6,30,16,41,12,53,19,6,11,1,20,104,39,29,24,68,Fortaleza B. C.,58,9,8,17,16,29,8,37,6,5,11,0,25,40,30,35,23,65
2020/2021,QUARTAS,Mogi,79,23,8,31,9,28,11,39,26,3,17,2,25,92,46,21,13,67,Flamengo,109,13,21,34,20,27,11,38,24,12,10,3,12,134,24,45,27,69
2020/2021,OITAVAS,Corinthians,89,18,10,28,23,28,11,39,25,11,10,3,20,108,39,32,29,71,Pato Basquete,84,27,5,32,15,34,16,50,23,7,16,3,26,100,53,22,23,75
2020/2021,OITAVAS,Bauru,74,17,11,28,7,16,7,23,18,5,9,3,23,79,31,28,11,59,KTO/Caxias do Sul,73,22,5,27,14,24,9,33,17,3,12,0,18,85,39,12,19,51
2020/2021,OITAVAS,Mogi,84,30,2,32,18,19,14,33,20,4,13,5,27,95,46,20,22,66,UNIFACISA,95,24,9,33,20,21,21,42,19,9,14,0,24,106,49,23,26,72
2020/2021,OITAVAS,Pato Basquete,61,14,9,23,6,20,12,32,11,7,17,0,23,53,34,26,10,60,Corinthians,90,19,12,31,16,28,16,44,19,7,12,2,18,109,36,29,23,65
2020/2021,OITAVAS,Fortaleza B. C.,64,9,12,21,10,22,6,28,12,7,17,3,16,60,24,31,13,55,Sesi Franca,82,21,10,31,10,30,5,35,20,10,13,2,14,107,37,21,12,58
2020/2021,OITAVAS,UNIFACISA,70,21,7,28,7,32,12,44,18,6,19,3,16,77,42,23,15,65,Mogi,77,19,10,29,9,26,8,34,20,12,11,3,17,93,36,32,12,68
2021/2022,2º TURNO,Corinthians,98,17,19,36,7,21,12,33,24,11,9,4,24,122,35,38,9,73,Mogi,75,15,9,24,18,24,18,42,24,5,22,2,15,81,33,26,28,59
2020/2021,OITAVAS,KTO/Caxias do Sul,65,21,4,25,11,21,15,36,13,10,18,1,19,66,42,19,16,61,Bauru,75,17,10,27,11,23,5,28,20,8,22,2,22,84,25,24,16,49
2021/2022,2º TURNO,BRB/Brasília,86,20,14,34,4,32,19,51,20,4,13,1,20,100,48,31,8,79,São Paulo,90,21,12,33,12,27,5,32,15,7,6,2,16,100,35,32,18,67
2021/2022,2º TURNO,Rio Claro,84,26,3,29,23,27,7,34,10,12,12,2,21,91,37,22,32,59,Pinheiros,80,18,8,26,20,24,12,36,17,8,19,2,24,82,38,25,25,63
2021/2022,1º TURNO,São Paulo,86,21,11,32,11,29,7,36,18,6,11,0,14,97,40,24,17,64,Pato Basquete,77,11,16,27,7,26,8,34,16,4,14,7,20,82,24,38,14,62
2021/2022,1º TURNO,Corinthians,74,18,9,27,11,41,10,51,16,4,17,3,18,88,36,30,15,66,Luvix/União Corinthians,63,16,7,23,10,27,13,40,18,10,7,4,18,66,46,30,19,76
2021/2022,1º TURNO,Cerrado Basquete,74,18,9,27,11,29,12,41,16,4,14,4,13,81,35,31,16,66,UNIFACISA,88,27,8,35,10,28,16,44,11,9,6,2,17,100,58,21,14,79
2021/2022,1º TURNO,BRB/Brasília,82,16,9,25,23,30,22,52,15,8,14,4,22,95,38,34,28,72,Fortaleza B. C.,75,19,9,28,10,28,15,43,16,3,15,1,21,74,39,33,15,72
2021/2022,1º TURNO,Flamengo,103,24,15,39,10,37,10,47,25,7,6,6,13,141,38,39,13,77,Bauru,59,19,5,24,6,28,5,33,17,5,12,1,13,60,42,23,8,65
2020/2021,2º TURNO,Fortaleza B. C.,92,18,13,31,17,35,15,50,19,12,18,3,20,100,40,43,23,83,Paulistano,97,25,11,36,14,39,19,58,27,10,16,5,20,122,44,41,24,85
2020/2021,2º TURNO,Bauru,81,23,8,31,11,41,9,50,17,8,21,7,15,106,39,24,15,63,Cerrado Basquete,69,15,11,26,6,25,12,37,15,11,11,2,14,65,44,34,12,78
2020/2021,2º TURNO,Pinheiros,84,23,8,31,14,26,4,30,19,12,16,3,23,96,38,24,19,62,VipTech CMB,75,17,9,26,14,27,13,40,17,8,20,1,21,74,31,30,26,61
2020/2021,2º TURNO,Fortaleza B. C.,83,24,6,30,17,27,15,42,14,10,14,0,21,88,44,26,24,70,VipTech CMB,84,19,11,30,13,26,8,34,11,5,17,3,25,81,32,28,22,60
2020/2021,2º TURNO,Cerrado Basquete,67,20,8,28,3,20,12,32,15,10,8,3,16,71,37,36,6,73,Paulistano,75,24,6,30,9,33,15,48,19,3,18,0,13,89,37,26,14,63
2020/2021,2º TURNO,Bauru,82,21,9,30,13,26,2,28,22,7,16,0,17,91,29,23,23,52,Mogi,91,15,18,33,7,25,10,35,25,5,14,1,22,103,27,42,11,69
2020/2021,2º TURNO,UNIFACISA,99,23,12,35,17,25,10,35,17,12,23,5,22,115,36,22,24,58,Pato Basquete,80,24,6,30,14,18,15,33,14,6,26,2,25,66,41,22,24,63
2020/2021,2º TURNO,Cerrado Basquete,63,17,6,23,11,30,11,41,13,6,11,0,15,68,40,25,13,65,Pinheiros,71,20,7,27,10,31,13,44,20,7,10,4,14,89,41,27,16,68
2020/2021,2º TURNO,UNIFACISA,72,16,10,26,10,23,9,32,16,4,11,4,22,71,42,26,14,68,Bauru,88,28,7,35,11,35,18,53,23,8,16,3,19,114,46,23,22,69
2021/2022,1º TURNO,123 Minas,91,19,12,31,17,25,7,32,26,9,14,2,15,115,34,25,20,59,Pinheiros,84,21,11,32,9,23,16,39,26,7,14,4,18,101,39,35,12,74
2020/2021,2º TURNO,VipTech CMB,74,17,9,26,13,24,12,36,12,4,13,1,21,71,36,29,17,65,Corinthians,86,20,11,31,13,28,9,37,17,7,12,2,18,101,34,28,18,62
2021/2022,1º TURNO,Mogi,68,15,11,26,5,32,13,45,22,8,25,6,18,86,29,31,9,60,Pato Basquete,72,13,12,25,10,20,16,36,14,15,15,3,16,74,40,30,16,70
2020/2021,2º TURNO,Mogi,97,25,12,37,11,36,11,47,26,8,8,2,20,131,36,39,14,75,BRB/Brasília,77,11,14,25,13,29,4,33,15,5,12,1,16,76,26,36,19,62
2021/2022,1º TURNO,Corinthians,104,22,15,37,15,26,14,40,28,10,7,3,24,142,32,37,19,69,Caxias do Sul Basquete,60,23,0,23,14,19,12,31,6,3,17,1,14,42,44,12,23,56
2021/2022,1º TURNO,Rio Claro,91,14,16,30,15,23,17,40,13,11,11,1,20,93,37,40,20,77,São Paulo,85,14,14,28,15,33,6,39,14,8,21,1,21,93,26,30,20,56
2021/2022,1º TURNO,Paulistano,90,23,12,35,8,30,10,40,19,8,14,0,18,107,34,33,12,67,Luvix/União Corinthians,78,16,10,26,16,24,7,31,11,9,12,2,19,79,34,32,16,66
2021/2022,1º TURNO,123 Minas,76,15,12,27,10,34,11,45,20,8,11,2,10,94,27,39,17,66,Bauru,64,16,10,26,2,32,7,39,18,7,12,2,17,74,31,37,4,68
2021/2022,1º TURNO,Flamengo,81,21,10,31,9,33,10,43,20,9,16,3,14,106,32,33,9,65,Pinheiros,64,21,5,26,7,23,21,44,10,7,10,3,14,63,50,27,11,77
2021/2022,1º TURNO,BRB/Brasília,60,17,7,24,5,28,11,39,11,5,16,2,13,57,39,25,9,64,UNIFACISA,79,20,11,31,6,32,11,43,16,12,9,1,18,100,42,29,8,71
2021/2022,1º TURNO,Cerrado Basquete,122,26,16,42,22,48,13,61,21,5,28,9,36,133,50,38,33,88,Fortaleza B. C.,126,30,9,39,39,34,19,53,15,14,12,4,26,122,73,25,58,98
2021/2022,1º TURNO,Sesi Franca,92,16,14,30,18,29,11,40,12,6,9,4,21,103,35,32,23,67,São Paulo,87,15,11,26,24,28,6,34,11,6,9,4,25,97,27,31,28,58
2021/2022,1º TURNO,Pinheiros,67,20,6,26,9,26,19,45,14,2,11,3,13,66,44,25,20,69,Corinthians,65,13,9,22,12,29,16,45,13,6,14,2,22,73,27,35,16,62
2020/2021,2º TURNO,Flamengo,88,17,12,29,18,32,17,49,14,10,15,2,9,106,39,28,22,67,Cerrado Basquete,57,21,4,25,3,24,17,41,13,6,14,4,18,56,45,29,5,74
2020/2021,2º TURNO,Pinheiros,47,16,3,19,6,22,10,32,15,9,17,1,14,47,41,16,8,57,Paulistano,69,16,9,25,10,29,21,50,18,9,15,0,17,83,37,30,16,67
2020/2021,2º TURNO,KTO/Caxias do Sul,83,18,9,27,20,35,9,44,13,3,14,2,21,89,35,28,26,63,Pato Basquete,85,19,13,32,8,28,9,37,18,4,6,3,27,89,40,33,19,73
2020/2021,2º TURNO,Minas,81,23,8,31,11,34,6,40,12,7,15,4,24,86,38,27,20,65,Bauru,79,21,5,26,22,31,17,48,15,10,12,2,21,83,44,30,33,74
2020/2021,2º TURNO,Fortaleza B. C.,84,16,14,30,10,33,8,41,23,9,15,5,21,110,27,35,15,62,Sesi Franca,69,17,6,23,17,27,12,39,13,10,9,1,15,74,43,24,22,67
2020/2021,2º TURNO,VipTech CMB,74,21,8,29,8,29,12,41,15,3,14,3,15,78,37,33,11,70,São Paulo,99,21,15,36,12,30,10,40,16,5,5,4,13,120,43,31,13,74
2020/2021,2º TURNO,KTO/Caxias do Sul,58,11,8,19,12,26,9,35,12,7,9,3,22,57,32,28,20,60,Flamengo,77,13,13,26,12,36,12,48,15,4,12,3,18,94,28,34,17,62
2020/2021,2º TURNO,Corinthians,93,23,11,34,14,23,12,35,19,10,16,3,17,109,43,23,17,66,UNIFACISA,79,26,7,33,6,20,13,33,17,11,17,0,21,86,44,26,6,70
2020/2021,2º TURNO,Paulistano,70,15,9,24,13,26,14,40,20,14,13,1,21,81,37,31,20,68,BRB/Brasília,66,14,8,22,14,34,16,50,13,10,20,2,18,76,34,27,20,61
2021/2022,1º TURNO,Luvix/União Corinthians,74,20,6,26,16,27,14,41,9,10,16,2,27,81,36,24,21,60,Pato Basquete,68,14,7,21,19,22,12,34,8,9,18,2,25,56,32,22,33,54
2020/2021,2º TURNO,Sesi Franca,93,26,10,36,11,33,9,42,19,5,10,2,20,112,54,18,14,72,Cerrado Basquete,81,20,8,28,17,28,3,31,12,5,7,2,20,82,38,27,22,65
2021/2022,1º TURNO,Bauru,97,17,15,32,18,21,9,30,25,13,9,2,31,109,32,41,26,73,Paulistano,98,24,7,31,29,35,8,43,17,8,18,2,27,115,38,19,38,57
2021/2022,1º TURNO,Fortaleza B. C.,64,18,6,24,10,22,8,30,10,7,13,0,20,48,40,31,13,71,Sesi Franca,110,27,13,40,17,40,9,49,24,8,13,6,16,151,37,31,22,68
2021/2022,1º TURNO,São Paulo,91,16,15,31,14,25,6,31,25,7,9,2,22,108,27,36,21,63,123 Minas,87,19,12,31,13,29,11,40,11,5,12,1,19,91,31,33,21,64
2021/2022,1º TURNO,UNIFACISA,81,15,14,29,9,28,7,35,11,8,13,0,23,81,28,39,12,67,Sesi Franca,85,18,12,30,13,34,7,41,7,4,15,3,14,90,26,35,17,61
2021/2022,1º TURNO,Caxias do Sul Basquete,73,18,10,28,7,26,8,34,18,9,16,3,20,84,36,27,9,63,Mogi,78,17,11,28,11,27,12,39,10,11,17,1,17,79,41,23,18,64
2021/2022,1º TURNO,Cerrado Basquete,75,27,5,32,6,24,8,32,17,13,12,2,19,84,45,27,9,72,Flamengo,91,17,15,32,12,33,17,50,22,5,18,3,11,105,34,37,21,71
2021/2022,1º TURNO,Caxias do Sul Basquete,80,25,6,31,12,32,6,38,23,8,15,7,23,105,37,23,19,60,Pato Basquete,67,19,5,24,14,28,14,42,9,8,13,1,20,66,46,22,18,68
2021/2022,1º TURNO,Bauru,77,16,11,27,12,26,6,32,18,8,11,4,15,94,34,24,15,58,Corinthians,71,17,10,27,7,27,7,34,17,6,14,5,22,82,34,25,12,59
2020/2021,2º TURNO,Pato Basquete,73,24,4,28,13,22,9,31,13,16,11,1,20,81,40,23,20,63,Mogi,62,13,8,21,12,27,11,38,17,5,26,4,19,65,29,25,14,54
2020/2021,2º TURNO,Minas,93,18,14,32,15,38,16,54,20,6,19,3,15,114,34,34,22,68,Pinheiros,61,9,10,19,13,24,2,26,11,9,14,4,22,51,24,36,18,60
2020/2021,2º TURNO,Corinthians,78,13,14,27,10,27,8,35,11,6,13,0,23,75,33,30,16,63,São Paulo,85,18,12,30,13,31,9,40,10,6,9,6,14,98,30,35,18,65
2020/2021,2º TURNO,Bauru,98,21,11,32,23,28,9,37,15,6,8,4,26,103,38,37,29,75,Fortaleza B. C.,97,24,11,35,16,34,16,50,12,4,13,3,21,102,46,29,27,75
2020/2021,2º TURNO,BRB/Brasília,89,17,12,29,19,32,9,41,20,7,10,1,25,105,36,31,24,67,VipTech CMB,79,17,9,26,18,30,6,36,13,4,15,1,25,76,33,29,24,62
2020/2021,2º TURNO,KTO/Caxias do Sul,77,14,12,26,13,29,8,37,14,6,12,0,17,82,24,35,20,59,Sesi Franca,71,22,6,28,9,27,5,32,18,6,11,2,21,82,42,19,12,61
2020/2021,2º TURNO,Pato Basquete,49,10,6,16,11,25,7,32,10,4,19,2,22,40,30,22,13,52,Paulistano,87,20,11,31,14,30,14,44,17,13,11,1,17,108,36,31,21,67
2020/2021,2º TURNO,Cerrado Basquete,80,21,10,31,8,26,10,36,13,9,18,1,19,85,44,20,11,64,São Paulo,86,25,8,33,12,24,7,31,16,11,11,2,13,100,43,22,15,65
2021/2022,1º TURNO,Luvix/União Corinthians,92,28,7,35,15,28,9,37,22,10,6,1,22,110,47,26,23,73,Mogi,80,18,11,29,11,32,4,36,14,3,19,1,20,79,26,31,19,57
2020/2021,2º TURNO,Minas,92,17,13,30,19,27,17,44,24,8,11,2,14,113,39,29,27,68,Fortaleza B. C.,66,20,7,27,5,23,12,35,12,4,17,5,23,66,28,35,8,63
2021/2022,1º TURNO,Paulistano,60,10,10,20,10,28,14,42,15,5,13,3,19,60,34,35,13,69,São Paulo,75,17,9,26,14,37,10,47,20,9,10,4,16,104,33,32,16,65
2021/2022,1º TURNO,Sesi Franca,87,18,12,30,15,28,10,38,17,9,11,4,20,104,40,29,16,69,BRB/Brasília,79,23,7,30,12,27,9,36,12,7,14,4,20,85,45,19,17,64
2021/2022,1º TURNO,Mogi,65,19,5,24,12,25,9,34,19,10,14,1,18,76,36,22,17,58,Pinheiros,82,20,9,29,15,27,10,37,12,5,12,2,16,89,38,21,22,59
2021/2022,1º TURNO,Flamengo,91,22,13,35,8,33,14,47,28,4,12,2,19,120,37,35,11,72,Fortaleza B. C.,74,22,7,29,9,26,12,38,24,7,10,3,15,86,48,22,18,70
2021/2022,1º TURNO,123 Minas,71,21,4,25,17,26,15,41,13,5,12,1,19,72,37,26,26,63,UNIFACISA,68,21,3,24,17,27,10,37,15,6,13,2,26,76,37,20,23,57
2021/2022,1º TURNO,Rio Claro,80,13,12,25,18,25,10,35,16,11,12,0,27,85,26,34,28,60,BRB/Brasília,58,12,4,16,22,28,11,39,8,7,23,0,24,47,27,23,30,50
2021/2022,1º TURNO,Mogi,76,21,9,30,7,27,10,37,17,5,12,2,16,87,36,29,10,65,Bauru,79,20,11,31,6,26,8,34,19,7,9,0,18,91,33,34,9,67
2021/2022,1º TURNO,Flamengo,89,14,14,28,19,27,4,31,17,4,14,1,15,102,18,30,25,48,UNIFACISA,70,21,6,27,10,18,9,27,10,6,10,0,24,65,37,25,13,62
2021/2022,1º TURNO,Sesi Franca,96,28,11,39,7,38,16,54,16,8,21,5,7,124,41,32,7,73,Cerrado Basquete,61,16,9,25,2,16,10,26,13,10,16,2,9,46,35,39,3,74
2021/2022,1º TURNO,123 Minas,101,22,14,36,15,27,12,39,21,9,12,0,18,120,36,37,16,73,Fortaleza B. C.,74,20,5,25,19,25,10,35,16,5,17,2,22,76,36,25,22,61
2020/2021,2º TURNO,Flamengo,98,22,15,37,9,23,8,31,22,13,10,0,15,119,35,37,9,72,Corinthians,85,23,8,31,15,26,8,34,15,8,17,1,18,92,37,23,20,60
2020/2021,2º TURNO,Sesi Franca,96,30,7,37,15,23,9,32,22,11,11,4,21,117,43,25,21,68,UNIFACISA,89,20,10,30,19,23,10,33,19,8,18,2,24,96,39,23,24,62
2020/2021,2º TURNO,Corinthians,78,16,9,25,19,25,10,35,16,2,10,2,19,90,30,25,22,55,Minas,65,19,4,23,15,22,18,40,14,4,12,2,23,67,39,26,19,65
2020/2021,2º TURNO,BRB/Brasília,79,19,10,29,11,24,4,28,16,7,12,1,21,78,36,32,13,68,Sesi Franca,96,25,9,34,19,37,6,43,25,8,14,3,15,127,41,24,22,65
2020/2021,2º TURNO,UNIFACISA,79,21,9,30,10,23,11,34,18,7,17,3,20,83,39,30,12,69,São Paulo,90,27,7,34,15,27,13,40,18,14,11,5,15,115,44,25,21,69
2020/2021,2º TURNO,Mogi,74,15,12,27,8,23,10,33,21,3,13,3,21,82,30,33,11,63,Flamengo,89,16,13,29,18,26,12,38,23,6,10,6,12,114,26,36,23,62
2020/2021,2º TURNO,Minas,85,22,9,31,14,26,13,39,18,3,13,1,19,91,41,23,23,64,Mogi,80,24,6,30,14,25,10,35,16,7,13,4,25,89,39,26,19,65
2020/2021,2º TURNO,Corinthians,91,22,10,32,17,27,13,40,26,3,11,3,23,112,36,31,22,67,Pato Basquete,82,18,9,27,19,23,13,36,13,6,11,0,17,83,46,22,21,68
2020/2021,2º TURNO,Flamengo,100,21,14,35,16,34,13,47,27,9,14,0,10,132,31,39,18,70,Pinheiros,63,22,5,27,4,22,3,25,22,9,15,2,16,68,40,23,6,63
2020/2021,2º TURNO,VipTech CMB,73,15,8,23,19,24,5,29,10,3,8,0,23,68,36,23,22,59,KTO/Caxias do Sul,89,21,9,30,20,32,13,45,21,4,9,1,21,111,37,26,27,63
2021/2022,1º TURNO,Pato Basquete,87,19,12,31,13,35,9,44,18,6,12,0,19,110,34,24,19,58,Bauru,53,13,6,19,9,21,6,27,10,8,15,2,19,41,31,22,19,53
2021/2022,1º TURNO,Corinthians,78,19,9,28,13,25,16,41,17,7,11,0,17,88,36,36,13,72,São Paulo,83,21,10,31,11,25,3,28,21,3,10,1,18,96,32,28,12,60
2021/2022,1º TURNO,Caxias do Sul Basquete,89,21,13,34,8,30,9,39,23,9,14,3,20,114,36,26,15,62,Luvix/União Corinthians,72,19,7,26,13,23,12,35,17,12,15,4,17,79,42,22,21,64
2021/2022,1º TURNO,Pato Basquete,81,15,15,30,6,34,9,43,13,8,16,3,20,93,34,32,9,66,Pinheiros,69,17,7,24,14,28,5,33,7,10,16,1,12,62,33,26,21,59
2021/2022,1º TURNO,Rio Claro,93,28,8,36,13,28,8,36,16,5,7,3,19,114,41,26,14,67,Cerrado Basquete,75,16,10,26,13,24,12,36,11,6,11,3,21,79,33,30,17,63
2021/2022,1º TURNO,São Paulo,89,17,14,31,13,24,4,28,25,10,9,2,12,107,29,36,17,65,Mogi,72,21,8,29,6,29,11,40,18,4,21,2,20,79,32,31,8,63
2021/2022,1º TURNO,UNIFACISA,99,17,16,33,17,24,12,36,13,8,9,3,17,112,37,28,23,65,Corinthians,87,16,14,30,13,23,12,35,15,5,10,0,19,94,35,32,14,67
2021/2022,1º TURNO,Pinheiros,83,19,12,31,9,32,14,46,16,5,15,4,22,90,42,30,17,72,Paulistano,73,20,6,26,15,30,12,42,14,8,13,4,19,83,44,25,17,69
2021/2022,1º TURNO,BRB/Brasília,72,22,4,26,16,27,8,35,11,7,16,2,21,69,41,17,26,58,Cerrado Basquete,82,17,13,30,9,28,13,41,23,5,14,4,25,97,36,33,14,69
2020/2021,2º TURNO,São Paulo,98,22,15,37,9,35,10,45,23,4,11,1,16,119,37,37,13,74,Fortaleza B. C.,76,28,3,31,11,27,7,34,19,6,11,2,18,82,46,24,16,70
2020/2021,2º TURNO,BRB/Brasília,70,21,7,28,7,22,6,28,12,7,19,1,28,60,37,27,10,64,Bauru,99,30,7,37,18,30,13,43,22,14,14,0,19,125,44,22,28,66
2020/2021,2º TURNO,Minas,74,24,5,29,11,25,7,32,15,8,7,5,20,89,42,20,16,62,KTO/Caxias do Sul,70,22,5,27,11,27,12,39,15,3,10,2,24,77,45,20,15,65
2020/2021,2º TURNO,Mogi,96,23,13,36,11,28,14,42,27,6,16,2,24,124,34,34,12,68,VipTech CMB,79,23,7,30,12,18,11,29,24,7,13,1,18,84,44,22,19,66
2020/2021,2º TURNO,Pato Basquete,89,15,12,27,23,30,8,38,19,13,18,2,28,96,30,29,38,59,Pinheiros,88,15,12,27,22,29,10,39,23,11,20,3,29,101,35,28,29,63
2020/2021,2º TURNO,São Paulo,92,20,13,33,13,34,12,46,21,17,9,4,6,127,39,36,15,75,BRB/Brasília,46,11,7,18,3,31,10,41,10,4,22,1,14,35,33,30,3,63
2020/2021,2º TURNO,Paulistano,81,20,11,31,8,23,7,30,26,11,10,1,17,104,32,29,13,61,UNIFACISA,65,17,8,25,7,24,11,35,14,5,19,2,14,67,34,23,10,57
2020/2021,2º TURNO,Mogi,62,18,6,24,8,28,16,44,17,7,10,1,15,67,48,25,13,73,Paulistano,69,13,12,25,7,33,16,49,20,4,15,3,18,83,30,39,10,69
2020/2021,2º TURNO,Fortaleza B. C.,77,23,5,28,16,29,14,43,13,7,16,3,18,82,48,20,21,68,Corinthians,83,15,16,31,5,26,5,31,24,5,14,1,21,94,30,37,5,67
2020/2021,2º TURNO,Flamengo,91,16,11,27,26,32,6,38,14,2,16,3,21,104,27,26,28,53,Bauru,86,20,13,33,7,20,6,26,18,9,10,1,26,91,41,27,11,68
2020/2021,2º TURNO,VipTech CMB,73,17,11,28,6,25,12,37,20,9,22,1,20,70,38,30,14,68,Sesi Franca,113,36,9,45,14,31,11,42,28,18,11,1,16,152,56,20,22,76
2021/2022,1º TURNO,UNIFACISA,72,21,4,25,18,21,12,33,11,11,12,0,17,70,42,25,21,67,Paulistano,87,19,15,34,4,32,7,39,18,5,20,2,20,103,32,28,6,60
2021/2022,1º TURNO,BRB/Brasília,77,20,9,29,10,27,13,40,14,2,12,0,17,82,32,29,17,61,123 Minas,82,18,11,29,13,23,13,36,14,8,8,2,18,93,32,34,17,66
2021/2022,1º TURNO,Fortaleza B. C.,78,26,7,33,5,27,12,39,8,3,9,1,20,82,41,26,9,67,Corinthians,66,16,8,24,10,24,16,40,7,3,8,0,12,62,27,31,22,58
2021/2022,1º TURNO,Pinheiros,88,20,12,32,12,28,19,47,13,8,16,3,13,100,41,29,17,70,Luvix/União Corinthians,66,16,8,24,10,22,8,30,14,5,16,1,15,60,35,27,12,62
2021/2022,1º TURNO,Bauru,89,23,9,32,16,24,6,30,22,6,14,0,21,104,32,25,20,57,Caxias do Sul Basquete,81,18,10,28,15,20,6,26,16,5,12,3,24,83,30,30,19,60
2021/2022,1º TURNO,Sesi Franca,86,17,10,27,22,31,14,45,17,2,16,2,17,99,31,31,24,62,Rio Claro,76,19,7,26,17,21,11,32,17,8,10,1,24,81,37,30,19,67
2021/2022,1º TURNO,Fortaleza B. C.,72,20,7,27,11,42,11,53,10,2,20,6,21,75,46,21,19,67,Paulistano,69,20,5,25,14,33,17,50,12,10,12,3,19,68,51,30,22,81
2021/2022,1º TURNO,Cerrado Basquete,74,21,9,30,5,22,11,33,19,3,8,3,14,79,40,31,9,71,123 Minas,90,24,11,35,9,31,12,43,17,5,10,4,16,113,43,23,14,66
2021/2022,1º TURNO,Pinheiros,75,17,8,25,17,34,13,47,17,7,19,5,19,88,33,29,24,62,Caxias do Sul Basquete,79,14,11,25,18,26,7,33,16,10,8,3,20,92,39,27,18,66
2021/2022,1º TURNO,BRB/Brasília,60,16,6,22,10,28,13,41,9,4,11,3,11,59,41,20,18,61,Flamengo,69,16,11,27,4,29,13,42,17,6,9,4,17,86,27,42,5,69
2021/2022,1º TURNO,Bauru,92,20,12,32,16,33,8,41,20,10,11,5,15,118,35,30,22,65,Luvix/União Corinthians,67,19,6,25,11,28,6,34,17,8,14,1,16,71,35,28,15,63
2020/2021,2º TURNO,Bauru,104,24,14,38,14,26,13,39,17,10,9,1,24,125,40,32,17,72,VipTech CMB,92,18,13,31,17,23,10,33,23,6,13,2,19,104,34,27,26,61
2020/2021,2º TURNO,Paulistano,76,11,12,23,18,22,11,33,18,6,12,3,23,82,25,31,27,56,Minas,74,16,10,26,12,26,14,40,14,7,13,4,22,81,36,27,20,63
2020/2021,2º TURNO,KTO/Caxias do Sul,81,20,10,30,11,19,11,30,17,4,16,0,17,82,41,18,16,59,Fortaleza B. C.,82,23,9,32,9,20,6,26,9,8,13,3,23,86,32,26,12,58
2020/2021,2º TURNO,Sesi Franca,91,22,9,31,20,32,5,37,13,6,14,3,26,103,40,21,23,61,Flamengo,94,13,16,29,20,26,13,39,22,5,11,4,24,105,25,45,27,70
2020/2021,2º TURNO,Pinheiros,46,13,4,17,8,33,10,43,8,8,15,2,11,37,40,25,15,65,Fortaleza B. C.,92,20,15,35,7,40,9,49,20,7,9,5,12,118,36,40,12,76
2020/2021,2º TURNO,São Paulo,84,15,12,27,18,33,11,44,20,2,10,3,15,101,32,33,22,65,Pato Basquete,85,22,10,32,11,28,8,36,25,5,5,2,20,106,38,33,14,71
2020/2021,2º TURNO,UNIFACISA,88,16,13,29,17,29,14,43,22,9,14,6,23,111,38,29,22,67,Mogi,70,18,6,24,16,26,14,40,19,9,18,4,22,79,41,23,21,64
2020/2021,2º TURNO,Corinthians,96,20,15,35,11,31,9,40,23,8,14,2,15,121,35,31,14,66,BRB/Brasília,70,23,7,30,3,22,14,36,12,8,16,0,17,64,46,28,5,74
2020/2021,2º TURNO,KTO/Caxias do Sul,91,22,11,33,14,27,10,37,22,5,10,0,19,102,44,26,20,70,Cerrado Basquete,88,24,9,33,13,26,7,33,17,5,10,6,21,103,43,24,15,67
2020/2021,2º TURNO,Sesi Franca,87,24,7,31,18,20,2,22,17,8,8,2,16,97,39,17,24,56,Minas,93,25,12,37,7,25,8,33,18,6,13,2,19,108,38,26,11,64
2020/2021,2º TURNO,Flamengo,93,18,18,36,3,29,20,49,24,8,9,0,20,115,36,46,7,82,São Paulo,74,17,9,26,13,27,4,31,10,4,12,3,17,73,37,19,20,56
2021/2022,1º TURNO,Minas,89,21,12,33,11,27,6,33,20,11,12,5,15,116,30,29,15,59,Rio Claro,61,21,4,25,7,22,12,34,17,6,16,3,21,62,40,22,13,62
2021/2022,1º TURNO,Pato Basquete,69,15,10,25,9,22,4,26,13,8,15,1,17,66,23,28,19,51,UNIFACISA,80,20,11,31,7,24,10,34,23,9,13,0,20,97,31,33,10,64
2021/2022,1º TURNO,Caxias do Sul Basquete,69,20,6,26,11,21,13,34,16,12,8,0,21,76,36,35,13,71,São Paulo,79,22,7,29,14,32,4,36,16,7,15,3,17,97,31,19,22,50
2021/2022,1º TURNO,Flamengo,65,16,9,25,6,26,13,39,13,3,8,0,18,60,32,37,14,69,Sesi Franca,80,19,9,28,15,33,10,43,17,5,7,1,17,99,32,32,19,64
2021/2022,1º TURNO,Mogi,86,16,10,26,24,31,10,41,21,9,14,5,21,107,36,24,31,60,Fortaleza B. C.,79,16,9,25,20,26,5,31,16,7,12,2,25,83,30,30,25,60
2021/2022,1º TURNO,Paulistano,75,20,7,27,14,25,16,41,16,9,11,1,23,74,49,29,20,78,BRB/Brasília,77,21,5,26,20,37,8,45,17,4,18,5,24,93,37,23,23,60
2021/2022,1º TURNO,Corinthians,79,20,10,30,9,24,11,35,15,4,12,2,19,83,33,36,10,69,Cerrado Basquete,89,21,10,31,17,28,17,45,24,6,11,3,17,114,50,22,18,72
2021/2022,1º TURNO,Luvix/União Corinthians,71,16,8,24,15,37,7,44,7,8,24,5,17,71,28,29,22,57,São Paulo,66,17,7,24,11,27,8,35,11,14,18,3,20,63,38,28,17,66
2021/2022,1º TURNO,Flamengo,91,17,12,29,21,36,9,45,22,8,15,3,20,117,27,33,27,60,Rio Claro,66,19,5,24,13,23,11,34,18,8,13,1,27,62,41,29,19,70
2021/2022,1º TURNO,Bauru,73,16,11,27,8,32,9,41,23,8,17,3,17,94,27,34,11,61,Pinheiros,68,16,8,24,12,28,10,38,13,11,12,5,17,79,36,29,15,65
2021/2022,1º TURNO,Minas,75,19,9,28,10,23,7,30,17,11,12,2,19,78,35,30,18,65,Sesi Franca,96,22,15,37,7,33,5,38,20,4,16,2,18,114,29,33,12,62
2020/2021,2º TURNO,VipTech CMB,78,18,11,29,9,30,12,42,22,4,14,0,21,85,38,29,18,67,Paulistano,86,22,10,32,12,30,9,39,22,8,9,0,13,101,40,27,22,67
2020/2021,2º TURNO,Bauru,101,15,19,34,14,33,8,41,25,3,10,1,16,129,26,33,21,59,Pato Basquete,55,13,6,19,11,20,9,29,12,7,13,1,19,46,34,25,16,59
2020/2021,2º TURNO,Mogi,84,16,13,29,13,34,12,46,21,2,17,5,26,100,34,35,14,69,Fortaleza B. C.,94,27,8,35,16,28,18,46,18,11,7,6,17,110,56,27,26,83
2020/2021,2º TURNO,Pinheiros,73,18,8,26,13,35,13,48,14,5,12,0,11,78,39,30,20,69,UNIFACISA,87,23,10,33,11,34,16,50,26,9,9,3,17,111,44,38,17,82
2020/2021,2º TURNO,Corinthians,83,12,16,28,11,28,7,35,17,6,13,2,15,95,31,30,13,61,Cerrado Basquete,61,21,4,25,7,26,14,40,10,11,14,0,13,65,50,17,8,67
2020/2021,2º TURNO,BRB/Brasília,66,14,6,20,20,21,6,27,9,2,15,1,22,53,28,26,23,54,KTO/Caxias do Sul,88,20,10,30,18,27,15,42,20,5,11,0,25,104,35,29,24,64
2020/2021,2º TURNO,São Paulo,90,20,11,31,17,26,6,32,19,3,10,1,20,104,34,26,19,60,Minas,92,15,17,32,11,23,13,36,19,3,9,2,21,100,34,31,21,65
2020/2021,2º TURNO,Paulistano,70,20,9,29,3,27,11,38,13,6,14,2,20,75,41,24,7,65,Flamengo,84,7,19,26,13,25,10,35,25,5,12,2,13,100,20,42,16,62
2020/2021,2º TURNO,Cerrado Basquete,78,20,8,28,14,25,9,34,12,9,14,1,19,80,39,25,18,64,Mogi,84,20,10,30,14,29,15,44,22,5,14,2,19,100,35,34,18,69
2021/2022,1º TURNO,Corinthians,73,12,11,23,16,29,10,39,15,4,7,3,17,80,25,43,18,68,BRB/Brasília,64,23,4,27,6,32,9,41,18,3,12,5,16,74,43,18,17,61
2020/2021,2º TURNO,Sesi Franca,109,30,10,40,19,40,10,50,25,7,10,2,20,146,45,27,24,72,Pato Basquete,68,13,8,21,18,26,9,35,16,6,10,1,25,64,38,33,20,71
2021/2022,1º TURNO,Flamengo,99,23,16,39,5,31,11,42,21,4,12,1,10,129,37,26,7,63,Minas,63,21,5,26,6,14,12,26,12,7,7,3,9,60,41,26,9,67
2021/2022,1º TURNO,Mogi,75,18,7,25,18,26,8,34,18,8,12,1,17,84,31,32,20,63,UNIFACISA,85,20,12,32,9,28,11,39,16,10,12,0,18,98,32,36,13,68
2021/2022,1º TURNO,Paulistano,85,24,9,33,10,27,12,39,17,2,10,4,16,93,47,26,14,73,Cerrado Basquete,84,26,7,33,11,31,14,45,17,7,11,5,16,103,50,23,15,73
2021/2022,1º TURNO,Pato Basquete,66,15,9,24,9,26,11,37,8,9,15,3,18,61,38,29,13,67,Fortaleza B. C.,63,19,4,23,13,33,4,37,8,7,22,0,17,59,34,16,20,50
2021/2022,1º TURNO,Cerrado Basquete,74,20,6,26,16,23,13,36,16,10,9,2,18,74,38,32,27,70,Mogi,86,23,10,33,10,38,4,42,20,5,15,4,21,112,38,24,11,62
2021/2022,1º TURNO,BRB/Brasília,53,19,3,22,6,34,8,42,11,2,15,2,16,52,34,27,10,61,Pato Basquete,70,18,9,27,7,32,7,39,15,6,9,1,17,76,40,28,12,68
2021/2022,1º TURNO,Sesi Franca,82,21,10,31,10,29,7,36,13,3,12,2,18,88,35,25,17,60,Paulistano,78,18,10,28,12,25,8,33,9,9,6,3,20,85,36,31,14,67
2021/2022,1º TURNO,Rio Claro,63,22,3,25,10,20,7,27,17,10,9,0,16,70,41,17,15,58,Corinthians,75,12,12,24,15,28,9,37,15,5,18,1,14,86,22,29,17,51
2020/2021,2º TURNO,Pinheiros,52,14,4,18,12,27,7,34,12,7,19,3,12,38,39,26,16,65,BRB/Brasília,97,22,15,37,8,41,13,54,30,11,17,3,18,137,39,34,13,73
2021/2022,1º TURNO,Cerrado Basquete,85,22,8,30,17,38,22,60,13,8,17,2,25,91,48,33,26,81,Pato Basquete,86,23,8,31,16,31,22,53,12,13,11,3,22,88,62,25,28,87
2020/2021,2º TURNO,UNIFACISA,88,18,14,32,10,23,7,30,19,8,13,3,21,98,39,28,12,67,KTO/Caxias do Sul,83,13,16,29,9,30,9,39,18,8,17,3,18,94,28,34,16,62
2020/2021,2º TURNO,Pato Basquete,67,15,8,23,13,20,4,24,14,12,14,1,20,65,34,24,17,58,Minas,83,18,12,30,11,33,3,36,22,6,20,1,21,102,28,26,13,54
2020/2021,2º TURNO,VipTech CMB,74,24,8,32,2,28,12,40,23,9,15,0,17,91,47,24,3,71,Flamengo,93,15,19,34,6,28,6,34,25,8,9,2,9,118,24,44,7,68
2020/2021,2º TURNO,Paulistano,63,11,12,23,5,37,16,53,17,7,12,0,21,69,32,45,10,77,São Paulo,71,15,10,25,11,39,14,53,15,4,9,1,9,80,35,40,16,75
2020/2021,2º TURNO,Mogi,87,13,15,28,16,34,6,40,23,3,14,1,25,105,22,37,20,59,Sesi Franca,75,17,8,25,17,26,7,33,12,3,9,2,21,72,36,28,22,64
2020/2021,2º TURNO,KTO/Caxias do Sul,76,12,9,21,25,38,6,44,14,7,16,2,19,87,29,25,32,54,Pinheiros,73,20,6,26,15,29,10,39,13,8,10,3,25,75,44,26,22,70
2020/2021,2º TURNO,Minas,91,23,9,32,18,39,12,51,21,4,16,2,17,117,45,19,22,64,VipTech CMB,70,20,9,29,3,21,6,27,15,8,7,2,24,66,41,30,10,71
2020/2021,2º TURNO,Pato Basquete,61,14,9,23,6,29,15,44,10,8,20,1,22,57,48,19,9,67,Flamengo,85,14,13,27,18,31,13,44,20,11,11,1,14,103,24,45,23,69
2020/2021,2º TURNO,BRB/Brasília,73,19,9,28,8,29,5,34,11,5,12,1,14,77,36,26,9,62,Cerrado Basquete,86,18,13,31,11,30,15,45,14,6,8,3,15,100,43,32,13,75
2020/2021,2º TURNO,Fortaleza B. C.,75,21,5,26,18,21,9,30,11,11,19,0,22,68,42,21,21,63,UNIFACISA,87,25,7,32,16,29,11,40,19,8,23,2,25,95,41,23,22,64
2021/2022,1º TURNO,BRB/Brasília,78,9,11,20,27,37,10,47,14,2,12,2,18,74,28,32,44,60,Mogi,73,16,8,24,17,37,12,49,12,7,10,4,30,80,37,37,22,74
2021/2022,1º TURNO,Fortaleza B. C.,77,24,6,30,11,30,13,43,18,6,11,2,18,91,51,16,18,67,Luvix/União Corinthians,76,20,9,29,9,24,15,39,15,8,9,2,17,83,41,32,13,73
2021/2022,1º TURNO,UNIFACISA,53,12,7,19,8,28,19,47,11,3,15,1,16,45,36,35,11,71,Caxias do Sul Basquete,70,18,8,26,10,35,5,40,14,9,11,3,15,91,38,20,12,58
2021/2022,1º TURNO,São Paulo,86,24,11,35,5,30,4,34,23,7,13,3,20,110,35,28,7,63,Pinheiros,70,13,9,22,17,25,14,39,15,6,13,2,13,71,38,27,22,65
2021/2022,1º TURNO,Sesi Franca,86,26,6,32,16,28,7,35,18,7,16,4,11,106,42,17,17,59,Corinthians,62,16,8,24,6,19,11,30,11,8,17,5,18,59,31,32,7,63
2021/2022,1º TURNO,Rio Claro,85,23,10,33,9,25,7,32,22,6,12,2,21,104,41,19,13,60,Paulistano,79,14,14,28,9,22,9,31,17,6,15,4,20,87,25,35,12,60
2021/2022,1º TURNO,Fortaleza B. C.,94,19,12,31,20,25,10,35,18,4,11,3,17,105,40,21,28,61,Caxias do Sul Basquete,85,22,10,32,11,24,9,33,18,6,13,3,23,95,42,22,16,64
2021/2022,1º TURNO,UNIFACISA,104,27,12,39,14,29,8,37,27,5,6,2,18,129,42,31,20,73,Luvix/União Corinthians,99,18,16,34,15,28,12,40,21,4,11,2,15,112,36,37,19,73
2021/2022,1º TURNO,Pato Basquete,72,17,10,27,8,25,11,36,13,2,17,2,21,69,32,25,17,57,Rio Claro,77,19,9,28,12,26,9,35,12,7,11,1,20,85,39,21,16,60
2021/2022,1º TURNO,Mogi,96,18,14,32,18,26,10,36,22,10,13,0,18,108,37,34,22,71,Sesi Franca,102,21,16,37,12,29,7,36,23,9,14,1,20,120,33,35,18,68
2020/2021,2º TURNO,KTO/Caxias do Sul,79,27,4,31,13,34,5,39,20,3,13,1,23,95,40,19,19,59,Corinthians,78,17,9,26,17,25,5,30,12,10,8,2,23,80,35,30,22,65
2020/2021,2º TURNO,São Paulo,100,22,12,34,20,31,13,44,24,8,10,4,13,132,31,36,25,67,Pinheiros,74,19,8,27,12,21,13,34,16,4,11,1,21,71,44,28,14,72
2020/2021,2º TURNO,Bauru,74,20,9,29,7,30,15,45,16,8,16,2,19,86,35,30,14,65,Sesi Franca,70,15,9,24,13,24,5,29,13,9,12,2,18,72,34,23,19,57
2020/2021,2º TURNO,BRB/Brasília,87,20,9,29,20,37,16,53,14,8,17,0,21,100,36,30,28,66,Fortaleza B. C.,67,21,6,27,7,22,5,27,13,9,12,2,27,61,38,30,11,68
2020/2021,2º TURNO,UNIFACISA,67,16,9,25,8,28,9,37,16,4,15,4,19,71,36,25,14,61,Cerrado Basquete,81,21,7,28,18,29,8,37,17,7,13,2,18,94,41,22,20,63
2020/2021,2º TURNO,Minas,94,30,7,37,13,29,9,38,21,1,12,5,31,109,54,20,14,74,Flamengo,96,21,10,31,24,28,15,43,16,6,11,3,20,103,35,38,32,73
2020/2021,2º TURNO,Pato Basquete,86,27,7,34,11,25,10,35,17,7,13,6,21,98,43,18,24,61,VipTech CMB,82,20,10,30,12,24,12,36,20,7,13,4,22,93,37,29,19,66
2020/2021,2º TURNO,São Paulo,92,25,10,35,12,27,7,34,20,5,18,4,16,114,37,20,13,57,Bauru,84,15,15,30,9,14,6,20,23,14,11,1,21,95,33,28,14,61
2020/2021,2º TURNO,Sesi Franca,90,22,8,30,22,24,6,30,16,6,17,1,16,103,40,13,22,53,Paulistano,82,20,11,31,9,17,7,24,21,14,13,1,21,95,33,31,10,64
2021/2022,1º TURNO,Paulistano,87,23,8,31,17,26,13,39,18,7,14,1,27,98,42,22,24,64,Flamengo,81,14,10,24,23,23,14,37,11,8,14,4,24,80,27,34,33,61
2020/2021,2º TURNO,Pinheiros,67,17,8,25,9,28,15,43,19,6,16,2,16,74,49,22,10,71,Corinthians,98,14,19,33,13,31,8,39,30,12,10,3,13,131,30,36,21,66
2021/2022,1º TURNO,Paulistano,67,17,8,25,9,22,9,31,15,7,13,1,18,63,39,27,13,66,Minas,96,23,14,37,8,34,10,44,16,10,15,1,15,119,39,30,9,69
2021/2022,1º TURNO,Caxias do Sul Basquete,76,22,7,29,11,24,16,40,23,13,11,4,24,99,45,24,17,69,BRB/Brasília,64,16,3,19,23,28,10,38,12,3,19,5,19,67,35,17,26,52
2021/2022,1º TURNO,Mogi,64,18,4,22,16,35,16,51,13,4,19,1,18,68,36,23,25,59,Rio Claro,60,14,6,20,14,25,16,41,10,9,12,1,23,53,43,24,23,67
2021/2022,1º TURNO,Bauru,84,22,11,33,7,25,14,39,18,4,8,3,22,106,31,35,8,66,UNIFACISA,68,14,8,22,16,20,8,28,18,6,8,2,15,78,27,26,21,53
2021/2022,1º TURNO,Pato Basquete,66,21,6,27,6,26,13,39,13,6,13,2,21,63,47,26,10,73,Sesi Franca,88,20,11,31,15,32,10,42,19,7,11,3,14,110,31,33,20,64
2021/2022,1º TURNO,Luvix/União Corinthians,70,14,12,26,6,23,10,33,7,17,10,2,20,74,33,37,7,70,BRB/Brasília,55,13,4,17,17,32,4,36,3,2,26,4,12,46,28,14,20,42
2021/2022,1º TURNO,Corinthians,65,14,8,22,13,24,10,34,17,6,10,4,17,68,29,37,17,66,Minas,82,18,11,29,13,34,12,46,18,7,13,3,17,105,32,31,17,63
2021/2022,1º TURNO,Pinheiros,67,16,9,25,8,21,18,39,15,3,10,0,13,64,32,39,12,71,UNIFACISA,86,14,16,30,10,28,7,35,21,8,14,0,17,107,25,33,11,58
2021/2022,1º TURNO,Caxias do Sul Basquete,72,26,4,30,8,32,10,42,21,11,15,3,13,98,44,20,10,64,Cerrado Basquete,64,17,8,25,6,24,9,33,13,9,15,0,16,62,33,31,9,64
2021/2022,1º TURNO,Bauru,74,14,10,24,16,28,11,39,20,6,13,4,13,91,28,33,18,61,Fortaleza B. C.,59,16,6,22,9,26,10,36,14,8,13,2,16,62,37,22,16,59
2020/2021,2º TURNO,Mogi,86,15,12,27,20,30,11,41,25,5,23,3,32,109,29,24,22,53,KTO/Caxias do Sul,75,17,5,22,26,15,16,31,12,10,11,3,22,63,33,31,41,64
2020/2021,2º TURNO,Fortaleza B. C.,86,22,9,31,15,34,9,43,13,15,19,6,20,99,43,24,24,67,Cerrado Basquete,77,18,10,28,11,30,16,46,12,13,19,4,21,74,46,33,19,79
2020/2021,2º TURNO,Paulistano,69,12,11,23,12,31,8,39,14,7,17,2,16,76,26,30,17,56,Bauru,64,20,5,25,9,26,12,38,14,9,11,1,17,68,46,21,14,67
2020/2021,2º TURNO,BRB/Brasília,86,23,6,29,22,28,8,36,17,7,20,1,20,94,37,19,28,56,UNIFACISA,103,27,12,39,13,21,8,29,24,12,9,2,25,121,42,30,20,72
2020/2021,2º TURNO,Sesi Franca,76,24,5,29,13,20,7,27,14,9,15,3,20,76,43,22,15,65,São Paulo,97,19,16,35,11,27,9,36,22,8,17,1,16,115,31,35,12,66
2020/2021,2º TURNO,Mogi,75,21,7,28,12,29,9,38,23,12,19,0,18,92,36,23,18,59,Corinthians,77,21,9,30,8,24,15,39,16,9,16,0,16,80,44,29,10,73
2020/2021,2º TURNO,Corinthians,98,22,14,36,12,31,12,43,19,5,18,5,23,105,46,33,16,79,Paulistano,100,26,8,34,24,30,23,53,16,10,14,0,21,109,57,26,31,83
2020/2021,2º TURNO,UNIFACISA,76,16,9,25,17,24,5,29,15,6,14,1,22,78,31,26,20,57,Minas,88,19,11,30,17,29,17,46,22,5,11,2,17,107,45,23,24,68
2020/2021,2º TURNO,Cerrado Basquete,77,17,8,25,19,25,14,39,18,7,19,4,30,82,41,20,27,61,Pato Basquete,76,19,5,24,23,25,11,36,9,6,17,0,26,70,40,20,27,60
2021/2022,1º TURNO,Corinthians,80,14,14,28,10,20,13,33,16,4,11,1,20,79,29,41,12,70,Flamengo,83,19,10,29,15,27,9,36,15,4,18,3,17,92,38,20,17,58
2021/2022,1º TURNO,BRB/Brasília,49,12,6,18,7,32,18,50,10,5,9,3,19,48,45,30,10,75,Bauru,60,17,4,21,14,40,8,48,12,4,13,4,19,73,31,27,19,58
2021/2022,1º TURNO,Pinheiros,81,21,8,29,15,32,23,55,19,13,12,4,20,107,43,31,23,74,Fortaleza B. C.,60,16,6,22,10,24,13,37,15,6,18,4,19,56,40,26,14,66
2021/2022,1º TURNO,Luvix/União Corinthians,75,25,6,31,7,33,20,53,18,16,17,5,24,85,67,23,13,90,Cerrado Basquete,76,15,12,27,10,40,12,52,11,6,24,2,18,72,36,33,19,69
2021/2022,1º TURNO,UNIFACISA,66,20,7,27,5,22,15,37,17,6,14,0,21,66,39,27,12,66,São Paulo,78,22,6,28,16,27,4,31,19,6,11,0,14,95,30,23,19,53
2021/2022,1º TURNO,Minas,79,13,12,25,17,33,16,49,23,5,15,0,21,95,26,32,30,58,Pato Basquete,67,16,7,23,14,27,5,32,18,7,10,1,25,71,30,28,23,58
2021/2022,1º TURNO,Sesi Franca,84,25,4,29,22,30,9,39,11,5,14,2,16,89,42,19,28,61,Caxias do Sul Basquete,75,21,8,29,9,23,2,25,22,6,14,1,29,76,34,23,20,57
2021/2022,1º TURNO,Cerrado Basquete,87,26,9,35,8,30,15,45,8,5,11,1,19,89,43,33,13,76,Bauru,92,26,8,34,16,28,4,32,19,6,9,5,17,109,43,23,20,66
2021/2022,1º TURNO,Flamengo,116,25,16,41,18,30,18,48,27,8,17,2,15,145,34,37,27,71,Mogi,73,21,8,29,7,18,18,36,18,9,15,1,26,69,48,29,12,77
2021/2022,1º TURNO,BRB/Brasília,92,20,10,30,22,30,7,37,20,8,18,2,19,106,45,17,25,62,Pinheiros,93,24,11,35,12,25,24,49,24,11,15,6,20,112,54,32,17,86
2021/2022,1º TURNO,Flamengo,94,17,17,34,9,34,14,48,31,10,17,4,14,131,29,38,15,67,Pato Basquete,62,15,6,21,14,20,6,26,16,14,14,0,17,60,39,22,18,61
2021/2022,1º TURNO,Fortaleza B. C.,68,23,5,28,7,29,17,46,10,7,11,0,14,69,48,30,8,78,São Paulo,81,26,9,35,2,33,8,41,18,6,11,3,13,101,39,30,5,69
2020/2021,2º TURNO,Flamengo,115,23,20,43,9,35,12,47,35,9,8,1,15,165,30,45,11,75,BRB/Brasília,58,16,6,22,8,21,17,38,14,5,16,0,9,42,40,29,18,69
2020/2021,2º TURNO,Pinheiros,77,17,12,29,7,24,12,36,18,9,15,2,16,83,34,35,11,69,Mogi,81,22,10,32,7,32,11,43,26,7,15,4,19,108,35,32,10,67
2020/2021,2º TURNO,Corinthians,74,16,10,26,12,36,18,54,16,4,12,1,20,87,43,28,17,71,Bauru,64,16,8,24,8,29,5,34,11,5,6,3,17,65,34,26,18,60
2021/2022,1º TURNO,Sesi Franca,115,22,18,40,17,43,9,52,29,6,11,5,14,155,35,35,28,70,Luvix/União Corinthians,74,12,14,26,8,23,6,29,17,7,12,1,22,63,27,44,16,71
2020/2021,2º TURNO,Paulistano,71,20,9,29,4,28,14,42,18,5,10,5,15,91,39,27,7,66,KTO/Caxias do Sul,64,17,7,24,9,25,9,34,15,4,11,4,15,70,40,21,12,61
2020/2021,2º TURNO,UNIFACISA,79,27,6,33,7,19,13,32,17,10,11,0,22,88,53,14,12,67,Flamengo,81,16,11,27,16,23,20,43,17,4,16,3,13,91,32,32,20,64
2020/2021,2º TURNO,BRB/Brasília,75,13,10,23,19,25,5,30,16,1,10,2,20,74,31,27,24,58,Minas,99,27,8,35,21,32,10,42,29,7,4,1,26,134,48,22,26,70
2020/2021,2º TURNO,Cerrado Basquete,74,20,8,28,10,35,15,50,14,7,17,3,15,88,43,22,16,65,VipTech CMB,57,16,6,22,7,25,16,41,12,8,12,2,18,54,41,31,11,72
2020/2021,2º TURNO,Fortaleza B. C.,68,19,8,27,6,25,18,43,16,8,10,3,19,74,43,31,13,74,Pato Basquete,71,15,9,24,14,32,11,43,12,8,13,1,15,82,38,21,19,59
2020/2021,2º TURNO,São Paulo,96,22,12,34,16,27,11,38,19,12,17,3,16,117,37,26,21,63,Mogi,72,18,8,26,12,21,11,32,13,8,19,2,20,67,37,28,14,65
2021/2022,1º TURNO,Pato Basquete,55,12,7,19,10,30,10,40,5,7,19,0,25,35,31,32,19,63,Paulistano,68,17,5,22,19,38,17,55,9,9,19,1,19,69,41,25,29,66
2021/2022,1º TURNO,Rio Claro,63,12,8,20,15,22,8,30,12,8,16,0,24,57,34,22,19,56,Caxias do Sul Basquete,65,7,13,20,12,30,6,36,17,7,19,5,27,79,20,26,18,46
2020/2021,2º TURNO,Pinheiros,101,27,13,40,8,26,10,36,31,14,14,3,24,126,49,31,13,80,Sesi Franca,99,18,14,32,21,33,4,37,24,11,21,2,20,117,36,26,26,62
2021/2022,1º TURNO,Cerrado Basquete,88,20,10,30,18,31,13,44,19,7,13,5,22,102,38,35,23,73,Pinheiros,79,24,7,31,10,31,19,50,16,5,14,5,23,87,55,22,18,77
2021/2022,1º TURNO,Minas,109,24,14,38,19,24,14,38,28,11,6,3,14,142,44,30,24,74,Mogi,75,17,10,27,11,24,9,33,20,3,19,6,17,84,29,31,12,60
2021/2022,1º TURNO,Rio Claro,74,14,9,23,19,32,12,44,16,9,14,2,20,89,29,30,25,59,Luvix/União Corinthians,63,17,5,22,14,28,5,33,12,10,12,3,21,69,33,26,17,59
2021/2022,1º TURNO,Paulistano,74,19,10,29,6,27,9,36,20,7,10,2,21,88,41,24,11,65,Corinthians,69,15,9,24,12,28,13,41,13,7,15,3,19,73,32,32,17,64
2021/2022,1º TURNO,Mogi,70,15,10,25,10,26,11,37,18,11,11,2,14,88,41,22,11,63,Corinthians,69,11,13,24,8,27,14,41,18,9,15,6,13,87,31,33,9,64
2021/2022,1º TURNO,São Paulo,85,21,12,33,7,24,4,28,24,7,7,4,14,104,33,30,14,63,BRB/Brasília,66,15,9,24,9,28,19,47,14,2,15,2,17,70,47,20,12,67
2020/2021,2º TURNO,KTO/Caxias do Sul,63,18,5,23,12,24,9,33,16,9,17,0,16,66,41,16,16,57,Bauru,71,16,10,26,9,25,8,33,17,10,16,4,18,84,32,25,13,57
2020/2021,2º TURNO,Flamengo,77,12,15,27,8,32,10,42,22,7,18,1,24,87,26,37,16,63,Fortaleza B. C.,74,26,3,29,13,28,7,35,14,10,13,2,22,81,47,19,17,66
2020/2021,2º TURNO,VipTech CMB,59,15,6,21,11,27,14,41,8,3,14,0,19,48,36,26,19,62,UNIFACISA,72,17,8,25,14,29,10,39,13,7,10,2,22,82,41,21,18,62
2020/2021,2º TURNO,Cerrado Basquete,80,19,9,28,15,20,11,31,19,13,10,3,17,91,40,26,22,66,Minas,93,19,13,32,16,30,9,39,17,4,18,6,18,112,34,26,17,60
2020/2021,2º TURNO,Pato Basquete,98,23,13,36,13,33,18,51,23,6,14,0,23,120,45,29,19,74,BRB/Brasília,76,12,11,23,19,22,7,29,17,7,10,2,15,77,27,34,25,61
2020/2021,2º TURNO,Sesi Franca,84,24,7,31,15,28,9,37,21,4,9,2,20,99,51,18,17,69,Corinthians,81,14,11,25,20,28,12,40,11,5,10,3,21,86,35,30,24,65
2020/2021,2º TURNO,Bauru,60,16,4,20,16,23,13,36,11,4,11,3,23,53,32,33,21,65,Pinheiros,72,22,4,26,16,35,9,44,18,6,16,3,25,91,41,17,20,58
2020/2021,1º TURNO,Corinthians,77,15,10,25,17,19,12,31,17,7,12,1,22,81,32,28,22,60,KTO/Caxias do Sul,83,22,7,29,18,22,12,34,15,6,13,1,24,91,39,17,26,56
2020/2021,2º TURNO,São Paulo,86,24,8,32,14,25,7,32,21,8,7,4,17,109,43,21,17,64,KTO/Caxias do Sul,81,17,12,29,11,27,8,35,19,1,13,0,21,87,32,27,17,59
2020/2021,1º TURNO,Pinheiros,89,21,13,34,8,23,13,36,24,11,12,3,18,105,40,32,16,72,Bauru,92,20,13,33,13,27,11,38,24,7,14,1,19,111,33,29,21,62
2020/2021,1º TURNO,UNIFACISA,89,23,12,35,7,25,4,29,24,13,10,3,16,115,46,20,9,66,Paulistano,77,16,12,28,9,28,7,35,18,7,16,2,12,85,31,32,12,63
2020/2021,1º TURNO,Cerrado Basquete,71,20,7,27,10,26,17,43,12,7,15,0,22,73,47,21,14,68,Corinthians,74,19,6,25,18,24,9,33,11,3,13,3,18,73,37,21,23,58
2021/2022,1º TURNO,Bauru,76,16,11,27,11,23,11,34,15,9,13,0,20,76,33,37,13,70,Sesi Franca,87,24,8,32,15,33,14,47,24,7,15,1,18,113,39,28,18,67
2021/2022,1º TURNO,Luvix/União Corinthians,59,18,6,24,5,25,9,34,9,12,17,3,20,50,41,31,7,72,Minas,77,21,6,27,17,38,11,49,8,6,22,3,14,83,38,24,20,62
2020/2021,1º TURNO,KTO/Caxias do Sul,87,21,10,31,15,26,8,34,15,5,14,0,20,84,40,29,20,69,Mogi,92,26,7,33,19,32,8,40,19,5,14,2,21,109,42,26,19,68
2020/2021,1º TURNO,Paulistano,68,21,7,28,5,35,12,47,17,9,14,6,16,92,36,28,10,64,Pinheiros,46,9,7,16,7,26,6,32,10,3,16,1,14,33,32,24,10,56
2020/2021,1º TURNO,Bauru,89,28,5,33,18,32,5,37,23,7,12,1,15,108,45,17,26,62,UNIFACISA,75,27,6,33,3,28,5,33,17,5,14,0,21,78,42,25,7,67
2020/2021,1º TURNO,BRB/Brasília,86,23,9,32,13,25,13,38,19,10,10,1,21,97,46,29,17,75,Mogi,90,19,13,32,13,31,11,42,21,6,15,4,18,109,37,31,16,68
2020/2021,1º TURNO,VipTech CMB,66,24,5,29,3,25,10,35,13,9,16,0,20,61,50,21,7,71,Cerrado Basquete,74,17,8,25,16,32,5,37,21,11,20,2,19,90,33,21,22,54
2020/2021,1º TURNO,Pato Basquete,77,19,6,25,21,24,9,33,15,4,14,3,18,76,39,21,28,60,KTO/Caxias do Sul,92,18,15,33,11,31,9,40,26,7,15,0,26,114,35,28,17,63
2020/2021,1º TURNO,Minas,70,16,10,26,8,33,4,37,18,6,12,0,20,89,26,29,9,55,Paulistano,63,14,7,21,14,26,14,40,12,6,9,1,16,64,32,36,16,68
2020/2021,1º TURNO,Fortaleza B. C.,71,20,6,26,13,41,11,52,11,4,13,6,15,87,40,25,18,65,Bauru,60,12,7,19,15,32,12,44,9,8,9,4,20,62,43,28,17,71
2020/2021,1º TURNO,Corinthians,96,19,14,33,16,38,6,44,19,1,12,2,23,120,30,30,19,60,VipTech CMB,72,26,4,30,8,22,18,40,11,3,4,3,19,62,58,22,21,80
2020/2021,1º TURNO,Cerrado Basquete,97,29,6,35,21,25,13,38,21,11,13,4,24,117,45,20,32,65,BRB/Brasília,85,19,8,27,23,21,9,30,19,6,15,0,23,86,38,22,29,60
2020/2021,1º TURNO,Mogi,78,20,7,27,17,30,16,46,17,9,13,5,24,96,37,33,20,70,Pato Basquete,63,19,4,23,13,28,12,40,15,8,17,0,18,61,44,19,21,63
2021/2022,1º TURNO,São Paulo,61,21,4,25,7,24,8,32,8,11,14,1,17,52,41,26,12,67,Flamengo,86,29,8,37,4,37,10,47,25,9,16,0,16,116,43,26,7,69
2020/2021,1º TURNO,Paulistano,78,13,14,27,10,31,12,43,22,3,14,0,12,93,24,39,13,63,Fortaleza B. C.,73,18,12,30,1,24,11,35,11,7,9,1,17,75,38,34,2,72
2020/2021,1º TURNO,Pato Basquete,75,17,9,26,14,21,12,33,14,7,9,2,25,72,47,22,21,69,Corinthians,80,23,7,30,13,34,13,47,16,3,17,1,21,93,34,28,18,62
2020/2021,1º TURNO,VipTech CMB,92,22,11,33,15,28,15,43,20,11,8,0,21,107,43,32,24,75,Mogi,86,22,9,31,15,29,7,36,22,7,15,4,20,101,39,24,22,63
2020/2021,1º TURNO,São Paulo,78,23,5,28,17,33,13,46,16,10,16,2,14,97,44,23,17,67,Paulistano,64,10,13,23,5,25,13,38,15,8,16,1,17,61,27,40,10,67
2020/2021,1º TURNO,Sesi Franca,82,19,8,27,20,23,4,27,20,4,13,3,25,90,37,18,25,55,Bauru,89,18,10,28,23,25,8,33,17,8,13,1,19,100,30,29,27,59
2020/2021,1º TURNO,Mogi,74,20,7,27,13,35,7,42,17,7,20,5,15,87,32,27,19,59,Pinheiros,68,21,7,28,5,29,10,39,19,8,15,2,19,72,42,30,10,72
2020/2021,1º TURNO,Corinthians,83,26,7,33,10,31,4,35,18,11,12,3,28,100,47,22,12,69,Flamengo,69,19,3,22,22,32,13,45,14,10,16,0,20,71,34,30,31,64
2020/2021,1º TURNO,VipTech CMB,94,27,11,38,7,26,15,41,22,12,12,0,19,114,44,32,12,76,BRB/Brasília,78,16,12,28,10,25,7,32,16,6,17,1,17,79,27,31,17,58
2020/2021,1º TURNO,Bauru,79,15,14,29,7,34,7,41,17,6,15,3,19,93,27,38,9,65,São Paulo,68,15,9,24,11,27,10,37,12,7,12,5,13,66,31,33,22,64
2020/2021,1º TURNO,Paulistano,87,20,12,32,11,27,13,40,17,8,13,1,18,92,42,36,13,78,Sesi Franca,85,28,6,34,11,31,6,37,18,5,12,3,17,99,49,19,14,68
2020/2021,1º TURNO,Flamengo,87,17,14,31,11,33,10,43,25,4,5,0,17,115,29,33,19,62,Mogi,56,12,7,19,11,26,18,44,12,4,9,3,18,54,42,25,19,67
2020/2021,1º TURNO,Fortaleza B. C.,92,17,16,33,10,27,5,32,13,8,8,1,14,105,33,31,12,64,São Paulo,85,15,15,30,10,26,11,37,22,6,11,2,16,102,33,34,12,67
2020/2021,1º TURNO,Minas,89,17,13,30,16,23,10,33,22,7,13,1,17,107,34,27,17,61,Sesi Franca,82,18,11,29,13,20,2,22,13,5,12,0,17,84,23,31,14,54
2020/2021,1º TURNO,UNIFACISA,72,18,7,25,15,23,5,28,11,8,15,1,20,69,33,26,17,59,Pinheiros,84,21,10,31,12,30,9,39,19,6,15,1,16,101,41,21,14,62
2020/2021,1º TURNO,Flamengo,80,19,7,26,21,29,14,43,14,4,11,3,19,87,41,25,27,66,KTO/Caxias do Sul,76,17,10,27,12,29,14,43,13,6,13,1,25,81,35,32,17,67
2020/2021,1º TURNO,Pato Basquete,79,15,11,26,16,27,7,34,12,12,11,3,21,92,31,25,23,56,Cerrado Basquete,68,19,7,26,9,25,13,38,16,5,16,2,23,70,40,23,15,63
2020/2021,1º TURNO,Sesi Franca,98,18,18,36,8,28,6,34,26,5,14,4,19,118,30,37,12,67,Fortaleza B. C.,81,21,7,28,18,25,10,35,14,9,13,2,17,87,40,23,24,63
2020/2021,1º TURNO,São Paulo,77,17,7,24,22,31,7,38,13,8,13,4,17,94,28,26,25,54,UNIFACISA,65,17,7,24,10,24,12,36,21,7,13,0,21,70,37,30,13,67
2020/2021,1º TURNO,Pinheiros,76,15,8,23,22,22,11,33,15,11,12,3,24,76,37,28,30,65,Minas,84,11,13,24,23,34,10,44,15,6,20,4,23,100,28,28,24,56
2020/2021,1º TURNO,Cerrado Basquete,67,18,7,25,10,25,11,36,13,3,11,1,19,63,42,18,21,60,Flamengo,87,22,11,33,10,28,11,39,19,5,10,0,23,100,31,36,16,67
2020/2021,1º TURNO,BRB/Brasília,98,17,15,32,19,32,18,50,19,9,20,3,30,103,37,37,33,74,Pato Basquete,104,29,8,37,22,33,14,47,22,12,16,3,28,120,46,31,34,77
2020/2021,1º TURNO,São Paulo,91,15,16,31,13,23,8,31,18,4,11,2,16,105,28,29,17,57,Cerrado Basquete,83,22,11,33,6,20,10,30,17,4,9,1,18,90,40,25,10,65
2020/2021,1º TURNO,Fortaleza B. C.,79,27,3,30,16,31,10,41,19,20,17,4,20,101,49,21,21,70,Pinheiros,62,15,7,22,11,32,15,47,17,8,25,4,18,60,37,28,21,65
2020/2021,1º TURNO,Minas,96,20,12,32,20,20,11,31,22,6,9,2,23,111,39,26,24,65,São Paulo,92,23,8,31,22,25,10,35,11,6,11,2,21,105,40,21,22,61
2020/2021,1º TURNO,UNIFACISA,92,18,12,30,20,29,12,41,16,8,14,1,21,103,33,33,25,66,Sesi Franca,85,15,13,28,16,25,8,33,16,5,14,4,19,88,34,28,23,62
2020/2021,1º TURNO,BRB/Brasília,74,18,11,29,5,25,7,32,21,4,18,1,13,74,34,34,6,68,Flamengo,103,22,16,38,11,31,12,43,32,13,12,2,8,142,31,44,13,75
2020/2021,1º TURNO,Mogi,74,16,9,25,15,26,7,33,18,5,14,1,21,78,34,26,19,60,Minas,80,20,8,28,16,28,16,44,17,6,12,1,20,92,38,29,21,67
2020/2021,1º TURNO,Paulistano,103,24,14,38,13,33,18,51,21,6,10,4,21,120,43,42,21,85,VipTech CMB,101,21,16,37,11,30,15,45,23,2,11,2,21,112,46,37,15,83
2020/2021,1º TURNO,VipTech CMB,75,22,5,27,16,25,15,40,19,5,12,0,17,86,42,24,18,66,Bauru,88,21,12,33,10,26,7,33,17,7,9,1,19,101,32,33,14,65
2020/2021,1º TURNO,Sesi Franca,84,20,8,28,20,17,12,29,25,7,8,1,24,98,34,28,26,62,KTO/Caxias do Sul,81,25,5,30,16,24,9,33,12,5,15,1,26,86,32,24,21,56
2020/2021,1º TURNO,Fortaleza B. C.,85,23,9,32,12,22,3,25,17,8,12,3,19,94,36,25,15,61,Mogi,88,15,14,29,16,25,11,36,26,8,17,3,20,110,32,29,18,61
2020/2021,1º TURNO,Sesi Franca,90,20,13,33,11,38,9,47,29,6,18,6,22,118,40,33,13,73,BRB/Brasília,93,17,15,32,14,31,8,39,22,10,11,3,20,106,36,42,18,78
2020/2021,1º TURNO,KTO/Caxias do Sul,89,24,9,33,14,18,12,30,17,4,11,0,25,88,42,29,17,71,São Paulo,109,24,13,37,22,26,6,32,26,8,10,1,18,137,37,24,27,61
2020/2021,1º TURNO,Pinheiros,80,14,14,28,10,30,12,42,17,6,11,4,18,90,41,29,16,70,Cerrado Basquete,77,15,11,26,14,33,10,43,17,6,13,3,19,88,34,29,22,63
2020/2021,1º TURNO,Paulistano,75,19,9,28,10,25,13,38,14,6,13,1,15,76,40,27,16,67,Pato Basquete,68,18,8,26,8,25,8,33,16,7,18,3,16,73,39,19,12,58
2020/2021,1º TURNO,Bauru,73,17,9,26,12,24,13,37,12,6,12,0,16,74,34,29,17,63,Flamengo,90,17,15,32,11,26,8,34,20,4,10,1,17,105,29,35,13,64
2020/2021,1º TURNO,BRB/Brasília,80,17,11,28,13,29,10,39,18,4,16,0,14,78,40,31,17,71,São Paulo,104,32,10,42,10,34,8,42,25,12,9,2,15,139,43,36,10,79
2020/2021,1º TURNO,Pinheiros,79,18,9,27,16,23,10,33,15,10,15,1,24,87,30,27,22,57,KTO/Caxias do Sul,72,16,8,24,16,23,5,28,14,10,20,1,22,73,32,17,23,49
2020/2021,1º TURNO,Mogi,98,24,10,34,20,32,9,41,23,6,6,4,19,119,49,25,27,74,UNIFACISA,91,20,14,34,9,36,7,43,13,1,12,3,28,96,39,33,14,72
2020/2021,1º TURNO,Flamengo,104,15,19,34,17,29,11,40,23,5,11,3,14,128,25,41,21,66,Paulistano,76,17,11,28,9,22,15,37,15,5,11,1,22,76,48,27,9,75
2020/2021,1º TURNO,UNIFACISA,94,27,10,37,10,26,12,38,17,10,11,2,14,118,46,21,12,67,Corinthians,74,15,12,27,8,18,6,24,12,8,14,2,16,72,27,31,11,58
2020/2021,1º TURNO,Pato Basquete,80,17,11,28,13,27,14,41,19,5,12,4,15,94,35,30,19,65,Bauru,79,19,10,29,11,24,3,27,17,10,9,0,18,90,31,27,16,58
2020/2021,1º TURNO,São Paulo,80,18,11,29,11,31,6,37,18,8,7,2,14,99,35,32,12,67,Flamengo,68,12,11,23,11,32,11,43,14,3,14,0,16,69,28,38,13,66
2020/2021,1º TURNO,Bauru,81,20,10,30,11,23,7,30,22,11,14,3,21,101,34,26,13,60,Paulistano,62,13,9,22,9,23,16,39,16,5,22,0,18,57,32,30,12,62
2020/2021,1º TURNO,Sesi Franca,95,23,11,34,16,36,14,50,29,13,13,1,20,133,40,33,19,73,VipTech CMB,58,11,9,20,9,25,13,38,11,6,19,1,18,41,27,37,19,64
2020/2021,1º TURNO,Pinheiros,85,19,10,29,17,27,15,42,19,6,18,2,21,90,41,28,23,69,Pato Basquete,77,22,5,27,18,28,13,41,14,13,19,6,22,88,49,17,23,66
2020/2021,1º TURNO,KTO/Caxias do Sul,65,19,6,25,9,17,8,25,8,6,14,1,16,52,38,21,14,59,UNIFACISA,90,25,11,36,7,29,11,40,15,8,14,0,18,107,38,26,11,64
2020/2021,1º TURNO,Bauru,82,15,12,27,16,28,9,37,18,11,11,0,20,98,33,26,23,59,Corinthians,67,16,7,23,14,25,9,34,15,8,14,2,20,70,36,25,18,61
2020/2021,1º TURNO,Minas,97,22,12,34,17,33,14,47,22,7,11,3,20,123,39,34,20,73,Cerrado Basquete,77,20,8,28,13,25,3,28,13,6,10,1,16,75,36,24,21,60
2020/2021,1º TURNO,Fortaleza B. C.,71,14,9,23,16,29,11,40,15,7,17,5,23,77,39,24,20,63,BRB/Brasília,63,16,7,23,10,30,13,43,12,6,19,5,18,63,31,31,18,62
2020/2021,1º TURNO,Flamengo,93,13,18,31,13,35,19,54,19,7,7,1,18,116,28,50,17,78,Sesi Franca,62,23,2,25,10,28,13,41,16,4,11,2,19,63,53,18,15,71
2020/2021,1º TURNO,Cerrado Basquete,73,18,7,25,16,35,14,49,12,5,13,2,23,84,35,28,22,63,Fortaleza B. C.,75,21,6,27,15,29,9,38,7,7,6,3,23,75,48,19,24,67
2020/2021,1º TURNO,Pato Basquete,71,25,4,29,9,24,11,35,9,6,14,0,19,69,44,17,15,61,São Paulo,80,20,10,30,10,23,15,38,10,10,12,6,16,92,38,29,13,67
2020/2021,1º TURNO,VipTech CMB,79,18,10,28,13,35,7,42,19,10,14,0,21,94,37,25,21,62,Pinheiros,66,16,7,23,13,27,11,38,16,7,16,2,22,62,41,21,25,62
2020/2021,1º TURNO,Paulistano,69,19,7,26,10,34,12,46,20,9,12,1,22,87,40,26,16,66,Mogi,62,11,8,19,16,32,8,40,17,7,15,0,21,67,26,29,24,55
2020/2021,1º TURNO,UNIFACISA,91,28,9,37,8,26,12,38,15,7,13,2,25,105,44,25,11,69,BRB/Brasília,74,12,9,21,23,20,20,40,13,4,14,1,12,66,32,36,28,68
2020/2021,1º TURNO,São Paulo,92,19,13,32,15,31,11,42,24,7,9,5,17,114,37,30,27,67,VipTech CMB,79,17,12,29,9,26,9,35,14,2,9,2,23,79,35,33,14,68
2020/2021,1º TURNO,KTO/Caxias do Sul,63,10,8,18,19,21,10,31,8,2,17,1,30,43,29,25,28,54,Minas,94,18,11,29,25,27,15,42,21,7,12,3,24,113,38,27,31,65
2020/2021,1º TURNO,Pinheiros,62,16,9,25,3,23,4,27,15,8,17,5,17,58,39,25,6,64,Flamengo,95,18,15,33,14,36,18,54,22,11,15,1,11,119,40,37,19,77
2020/2021,1º TURNO,Fortaleza B. C.,85,18,8,26,25,31,6,37,11,7,15,5,24,92,31,24,34,55,KTO/Caxias do Sul,78,16,9,25,19,28,12,40,13,6,11,0,30,76,34,32,28,66
2020/2021,1º TURNO,Minas,105,28,7,35,28,27,13,40,21,9,20,1,27,118,45,25,31,70,BRB/Brasília,100,13,16,29,26,22,10,32,15,8,20,1,28,93,26,39,33,65
2020/2021,1º TURNO,Cerrado Basquete,67,19,6,25,11,29,15,44,14,5,16,3,23,71,42,25,15,67,UNIFACISA,75,18,8,26,15,29,14,43,19,7,14,3,20,88,42,24,20,66
2020/2021,1º TURNO,Corinthians,81,17,9,26,20,24,12,36,15,8,13,1,17,85,32,31,26,63,Mogi,87,23,10,33,11,26,11,37,25,7,13,2,23,107,38,28,16,66
2020/2021,1º TURNO,Mogi,81,11,15,26,14,27,4,31,18,5,13,2,20,96,25,28,15,53,Cerrado Basquete,75,19,7,26,16,24,9,33,22,6,9,0,20,87,38,21,23,59
2020/2021,1º TURNO,Cerrado Basquete,67,14,8,22,15,24,10,34,13,10,13,1,23,77,29,26,17,55,KTO/Caxias do Sul,63,18,4,22,15,23,12,35,14,8,15,1,18,67,38,16,22,54
2020/2021,1º TURNO,Brasília,71,15,8,23,17,29,7,36,15,1,9,2,21,73,41,20,22,61,Corinthians,85,16,11,27,20,33,10,43,18,5,9,2,21,102,31,35,23,66
2020/2021,1º TURNO,Flamengo,105,14,18,32,23,32,8,40,26,8,6,5,20,141,21,43,28,64,Pato Basquete,70,17,8,25,12,28,16,44,14,4,13,1,28,70,52,21,14,73
2020/2021,1º TURNO,KTO/Caxias do Sul,62,19,7,26,3,24,8,32,15,4,12,2,19,60,41,24,7,65,Paulistano,86,23,9,32,13,32,10,42,19,6,8,3,14,112,39,27,15,66
2020/2021,1º TURNO,Brasília,84,20,10,30,14,25,6,31,20,6,14,2,16,98,31,23,21,54,Pinheiros,78,17,11,28,11,19,11,30,20,8,14,0,22,82,37,27,15,64
2020/2021,1º TURNO,Minas,108,23,13,36,23,30,11,41,25,5,12,5,23,138,39,27,27,66,UNIFACISA,99,27,10,37,15,20,12,32,21,8,7,1,22,108,54,25,19,79
2020/2021,1º TURNO,São Paulo,90,17,13,30,17,22,10,32,16,7,14,0,21,93,32,33,20,65,Sesi Franca,96,18,14,32,18,26,9,35,18,5,12,2,19,111,33,30,20,63
2020/2021,1º TURNO,Flamengo,78,22,7,29,13,35,14,49,19,11,20,2,10,100,39,27,15,66,VipTech CMB,63,11,13,24,2,24,5,29,18,10,16,4,19,65,36,30,3,66
2020/2021,1º TURNO,Paulistano,72,20,6,26,14,29,9,38,16,9,15,4,15,95,35,19,15,54,Cerrado Basquete,61,19,5,24,8,18,18,36,11,12,12,2,16,61,48,21,12,69
2020/2021,1º TURNO,Bauru,74,19,6,25,18,32,14,46,18,9,10,1,21,99,42,19,21,61,KTO/Caxias do Sul,54,15,4,19,12,24,8,32,10,3,14,2,19,43,31,22,22,53
2020/2021,1º TURNO,Pinheiros,73,22,7,29,8,26,11,37,19,3,17,2,20,74,49,18,13,67,São Paulo,100,28,11,39,11,29,10,39,19,9,11,5,15,122,50,25,14,75
2020/2021,1º TURNO,Pato Basquete,85,22,8,30,17,33,14,47,19,8,17,2,20,99,47,21,24,68,UNIFACISA,76,17,8,25,18,26,14,40,16,11,13,3,18,79,44,24,29,68
2020/2021,1º TURNO,Sesi Franca,94,24,10,34,16,24,12,36,24,5,15,2,15,110,39,28,19,67,Mogi,82,18,13,31,7,22,13,35,16,10,17,1,24,88,35,34,8,69
2020/2021,1º TURNO,Cerrado Basquete,81,18,11,29,12,24,8,32,13,3,14,3,18,82,31,29,17,60,Bauru,83,28,5,33,12,23,12,35,16,9,9,2,20,97,46,20,18,66
2020/2021,1º TURNO,Paulistano,75,19,8,27,13,27,9,36,15,7,10,2,20,85,39,26,15,65,Corinthians,74,16,8,24,18,30,10,40,17,4,13,4,22,87,39,21,21,60
2020/2021,1º TURNO,KTO/Caxias do Sul,84,18,12,30,12,28,13,41,19,9,14,3,20,107,37,24,16,61,Brasília,69,19,6,25,13,22,10,32,15,6,12,4,16,75,38,22,17,60
2020/2021,1º TURNO,UNIFACISA,69,23,4,27,11,34,8,42,16,5,17,1,19,81,39,23,11,62,Fortaleza B. C.,67,20,7,27,6,27,8,35,14,7,11,3,16,69,44,25,10,69
2020/2021,1º TURNO,Mogi,75,17,11,28,8,27,12,39,22,5,21,2,20,81,36,32,9,68,São Paulo,112,19,17,36,23,29,5,34,16,9,6,2,15,131,32,36,27,68
2020/2021,1º TURNO,Corinthians,76,17,11,28,9,25,5,30,20,8,19,5,20,86,28,31,12,59,Pinheiros,74,21,6,27,14,27,13,40,17,3,19,0,20,74,53,12,17,65
2020/2021,1º TURNO,Bauru,93,22,12,34,13,28,9,37,21,8,13,0,25,110,39,30,14,69,Brasília,70,14,8,22,18,25,8,33,12,5,20,0,12,58,31,22,29,53
2020/2021,1º TURNO,Flamengo,86,22,10,32,12,32,14,46,18,6,16,2,20,100,36,33,17,69,UNIFACISA,79,18,10,28,13,23,13,36,16,12,11,1,24,84,41,31,18,72
2020/2021,1º TURNO,Sesi Franca,80,18,8,26,20,36,9,45,19,7,15,3,23,104,35,23,23,58,Pinheiros,60,19,3,22,13,24,14,38,14,9,13,1,23,57,49,21,17,70
2020/2021,1º TURNO,Cerrado Basquete,79,16,10,26,17,21,11,32,14,5,15,3,22,82,33,28,18,61,Sesi Franca,86,18,9,27,23,22,11,33,16,10,11,6,16,104,40,19,27,59
2020/2021,1º TURNO,Brasília,57,13,8,21,7,26,5,31,16,2,13,3,13,58,33,24,9,57,Paulistano,73,14,11,25,12,31,15,46,17,6,10,2,17,91,38,28,14,66
2020/2021,1º TURNO,Pato Basquete,69,15,6,21,21,20,15,35,12,6,11,2,23,60,42,22,31,64,Fortaleza B. C.,76,18,9,27,13,31,13,44,17,6,19,2,26,90,35,24,17,59
2020/2021,1º TURNO,São Paulo,107,23,16,39,13,36,6,42,23,9,10,3,16,146,31,33,16,64,Corinthians,61,16,7,23,8,19,7,26,16,5,15,1,19,50,39,25,11,64
2020/2021,1º TURNO,VipTech CMB,54,19,3,22,7,24,15,39,14,3,16,0,21,46,39,25,13,64,Minas,90,24,10,34,12,29,11,40,17,10,9,1,16,111,41,24,19,65
2020/2021,1º TURNO,Mogi,85,22,9,31,14,20,6,26,21,7,16,3,25,90,35,23,23,58,Bauru,90,19,11,30,19,22,13,35,15,12,16,1,24,101,37,25,23,62
2020/2021,1º TURNO,Minas,76,16,10,26,14,37,8,45,19,8,20,3,25,100,24,28,19,52,Pato Basquete,54,9,8,17,12,17,8,25,10,7,12,1,21,32,28,32,22,60
2020/2021,1º TURNO,Fortaleza B. C.,69,23,6,29,5,32,8,40,20,6,14,4,22,80,46,26,7,72,Flamengo,82,15,11,26,19,34,14,48,18,9,13,3,11,99,29,40,24,69
2020/2021,1º TURNO,UNIFACISA,86,24,9,33,11,25,12,37,19,5,12,1,20,96,43,27,14,70,VipTech CMB,88,22,11,33,11,28,10,38,22,3,11,2,16,99,37,31,19,68
2020/2021,1º TURNO,Flamengo,102,21,14,35,18,33,11,44,29,5,11,3,16,129,33,35,28,68,Minas,68,21,7,28,5,26,6,32,21,7,14,2,21,71,44,22,12,66
2022/2023,QUARTAS,Sesi Franca,100,18,16,34,16,32,6,38,20,4,16,3,21,114,35,28,22,63,UNIFACISA,78,15,14,29,6,23,9,32,17,11,13,2,20,80,37,33,12,70
2020/2021,1º TURNO,VipTech CMB,61,11,9,20,12,25,19,44,15,1,17,5,22,65,26,35,15,61,Fortaleza B. C.,74,22,6,28,12,23,14,37,18,6,7,4,18,88,42,21,21,63
2022/2023,QUARTAS,Flamengo,86,16,11,27,21,28,8,36,22,6,10,0,25,102,28,29,29,57,Bauru Basket,84,12,15,27,15,24,9,33,21,5,10,0,24,92,31,31,21,62
2022/2023,QUARTAS,São Paulo,85,18,9,27,22,27,10,37,19,6,10,0,19,92,36,30,28,66,Pinheiros,73,22,6,28,11,33,15,48,14,4,19,2,22,79,37,31,14,68
2022/2023,QUARTAS,Pinheiros,115,31,12,43,17,20,17,37,23,5,11,2,25,131,47,28,25,75,São Paulo,107,25,12,37,21,19,10,29,20,7,10,0,25,116,41,25,29,66
2022/2023,QUARTAS,123 Minas,68,20,5,25,13,24,5,29,17,1,14,5,20,72,33,23,16,56,Paulistano,83,28,6,34,9,26,16,42,20,8,7,2,20,100,50,24,17,74
2022/2023,QUARTAS,UNIFACISA,92,20,9,29,25,22,4,26,16,2,8,0,21,97,32,24,29,56,Sesi Franca,90,15,17,32,9,23,10,33,24,3,10,1,29,108,34,30,10,64
2022/2023,QUARTAS,Pinheiros,60,16,4,20,16,23,15,38,14,10,17,0,17,61,37,20,23,57,São Paulo,77,13,15,28,6,25,11,36,14,10,16,2,24,86,27,34,10,61
2022/2023,QUARTAS,Bauru Basket,91,26,12,38,3,20,6,26,23,8,10,2,21,106,38,31,6,69,Flamengo,80,14,14,28,10,24,12,36,18,2,20,2,16,84,26,33,13,59
2022/2023,QUARTAS,Paulistano,68,19,6,25,12,21,13,34,8,11,7,2,22,65,41,31,16,72,123 Minas,77,20,7,27,16,35,2,37,17,5,16,1,19,98,27,23,16,50
2022/2023,QUARTAS,UNIFACISA,73,19,9,28,8,24,5,29,15,3,6,1,22,72,39,27,13,66,Sesi Franca,86,15,14,29,14,35,5,40,14,4,10,1,19,102,29,29,18,58
2022/2023,OITAVAS,Corinthians,70,18,6,24,16,23,13,36,13,5,14,4,17,77,34,26,17,60,UNIFACISA,81,21,9,30,12,21,11,32,16,9,8,3,20,96,39,24,16,63
2022/2023,QUARTAS,Bauru Basket,76,16,9,25,17,19,6,25,9,11,13,4,20,74,32,29,19,61,Flamengo,85,18,11,29,16,29,7,36,16,8,23,1,23,96,30,23,19,53
2022/2023,OITAVAS,Bauru Basket,71,15,9,24,14,31,9,40,18,7,14,1,19,86,30,28,17,58,Oscar São José Basketball,66,13,9,22,13,25,10,35,14,7,16,2,20,65,32,25,21,57
2022/2023,QUARTAS,Sesi Franca,91,20,12,32,15,29,13,42,13,4,12,2,20,98,35,36,18,71,UNIFACISA,100,19,17,36,11,27,10,37,13,8,8,0,20,107,39,34,17,73
2022/2023,QUARTAS,Paulistano,80,18,8,26,20,30,11,41,15,5,10,1,22,89,43,25,21,68,123 Minas,76,19,8,27,14,30,4,34,16,5,11,2,21,88,35,24,16,59
2022/2023,QUARTAS,São Paulo,92,17,12,29,22,34,7,41,17,5,11,2,26,112,26,32,27,58,Pinheiros,77,13,10,23,21,25,19,44,13,7,9,2,25,77,45,26,30,71
2022/2023,QUARTAS,123 Minas,85,20,10,30,15,27,12,39,17,7,14,1,20,99,35,27,19,62,Paulistano,82,19,12,31,8,22,19,41,14,8,11,5,23,88,43,33,14,76
2022/2023,QUARTAS,Flamengo,90,14,18,32,8,35,9,44,22,3,16,4,14,120,25,31,11,56,Bauru Basket,58,16,6,22,8,16,8,24,9,11,8,2,18,50,35,27,14,62
2022/2023,OITAVAS,Paulistano,92,25,9,34,15,20,17,37,16,7,13,7,21,110,37,28,20,65,Pato Basquete,78,21,6,27,18,15,17,32,9,7,12,2,24,75,40,27,19,67
2022/2023,OITAVAS,Pinheiros,78,23,5,28,17,33,17,50,13,8,10,4,23,92,53,21,22,74,Caxias do Sul Basquete,60,14,5,19,17,31,6,37,14,5,18,7,24,59,37,19,26,56
2022/2023,2º TURNO,Corinthians,90,25,8,33,16,27,9,36,22,6,11,5,23,108,40,32,17,72,BRB/Brasília,73,16,6,22,23,29,13,42,15,5,18,2,22,76,42,19,27,61
2022/2023,OITAVAS,Paulistano,90,18,16,34,6,28,14,42,20,10,16,2,17,114,30,36,8,66,Pato Basquete,57,10,9,19,10,19,9,28,10,10,19,0,14,44,24,34,13,58
2022/2023,OITAVAS,Bauru Basket,79,18,10,28,13,20,12,32,22,11,14,0,21,92,33,29,17,62,Oscar São José Basketball,83,21,9,30,14,23,6,29,19,3,14,3,17,93,32,22,20,54
2022/2023,OITAVAS,UNIFACISA,95,27,9,36,14,31,7,38,15,4,11,1,23,113,37,26,16,63,Corinthians,77,16,10,26,15,21,9,30,14,7,12,2,17,77,36,25,21,61
2022/2023,OITAVAS,Caxias do Sul Basquete,59,18,6,24,5,24,13,37,8,6,12,1,18,49,40,31,8,71,Pinheiros,73,22,7,29,8,37,12,49,21,9,15,1,20,101,43,21,10,64
2022/2023,2º TURNO,Caxias do Sul Basquete,66,14,10,24,8,26,6,32,13,8,14,3,19,68,33,28,11,61,Fortaleza B. C.,77,18,11,29,8,31,4,35,16,10,14,0,18,92,37,22,10,59
2022/2023,OITAVAS,Pato Basquete,82,20,7,27,21,31,14,45,13,6,13,2,22,95,37,23,28,60,Paulistano,70,13,9,22,17,22,12,34,9,5,12,1,27,58,29,32,27,61
2022/2023,OITAVAS,Oscar São José Basketball,77,20,10,30,7,20,9,29,24,5,11,1,18,90,36,25,11,61,Bauru Basket,95,19,13,32,18,24,7,31,21,10,9,2,17,122,34,24,20,58
2022/2023,2º TURNO,São Paulo,95,27,10,37,11,38,6,44,21,10,12,0,9,126,38,30,12,68,Cerrado,64,14,11,25,3,24,10,34,16,5,14,2,10,59,31,41,4,72
2022/2023,2º TURNO,União Corinthians,91,23,10,33,15,44,11,55,25,4,8,3,19,117,37,37,27,74,Fortaleza B. C.,75,19,7,26,16,34,8,42,15,5,8,1,26,78,41,34,19,75
2022/2023,2º TURNO,Corinthians,78,21,8,29,12,35,6,41,17,4,12,4,18,95,36,25,17,61,Cerrado,66,20,6,26,8,29,13,42,15,8,12,1,16,70,38,32,14,70
2022/2023,2º TURNO,Paulistano,113,31,10,41,21,32,11,43,21,6,14,3,22,143,43,23,25,66,BRB/Brasília,71,18,5,23,20,18,8,26,14,7,17,0,23,59,39,24,22,63
2022/2023,2º TURNO,Rio Claro,80,18,9,27,17,30,9,39,22,7,14,1,19,87,37,31,24,68,Oscar São José Basketball,92,26,9,35,13,36,9,45,29,6,13,0,22,117,47,26,17,73
2022/2023,2º TURNO,Paulistano,99,22,13,35,16,41,11,52,21,3,14,6,22,136,36,25,21,61,São Paulo,57,15,5,20,12,14,14,28,10,7,8,0,20,37,39,31,19,70
2022/2023,2º TURNO,Sesi Franca,83,16,13,29,12,29,2,31,11,5,15,2,21,92,27,26,13,53,Flamengo,70,16,9,25,11,21,10,31,13,5,12,0,18,66,25,38,14,63
2022/2023,2º TURNO,Pato Basquete,98,24,12,36,14,25,11,36,18,12,11,4,21,121,35,32,19,67,Cerrado,91,19,12,31,17,21,6,27,13,10,15,2,15,96,30,30,20,60
2022/2023,2º TURNO,Bauru Basket,81,20,10,30,11,33,9,42,21,9,15,1,18,98,38,28,16,66,União Corinthians,61,17,7,24,6,29,11,40,17,7,20,2,17,60,32,31,14,63
2022/2023,2º TURNO,Bauru Basket,89,25,5,30,24,30,15,45,14,5,12,2,20,108,44,19,26,63,Caxias do Sul Basquete,69,14,10,24,11,20,3,23,11,5,12,1,22,59,25,28,20,53
2022/2023,2º TURNO,Rio Claro,53,13,4,17,15,26,13,39,11,6,19,1,23,41,39,21,22,60,Flamengo,100,29,10,39,12,34,15,49,16,10,11,4,17,123,43,31,22,74
2022/2023,2º TURNO,Fortaleza B. C.,85,21,10,31,13,24,6,30,11,6,9,1,19,83,38,28,19,66,123 Minas,94,13,17,30,17,32,9,41,15,3,14,1,16,106,27,35,19,62
2022/2023,2º TURNO,Pinheiros,94,24,12,36,10,31,13,44,17,9,13,1,18,111,42,31,14,73,União Corinthians,70,9,11,20,19,22,9,31,15,8,18,1,18,63,21,35,27,56
2022/2023,2º TURNO,Pato Basquete,91,24,11,35,10,34,7,41,25,11,11,1,30,119,38,32,14,70,BRB/Brasília,64,8,8,16,24,29,9,38,10,6,23,0,20,49,26,26,34,52
2022/2023,2º TURNO,Cerrado,68,12,12,24,8,24,12,36,17,5,19,1,19,62,28,38,12,66,Sesi Franca,106,24,12,36,22,31,7,38,31,12,9,1,16,143,34,32,28,66
2022/2023,2º TURNO,UNIFACISA,79,14,10,24,21,31,6,37,15,8,12,3,16,90,33,25,27,58,123 Minas,69,13,12,25,7,29,7,36,13,6,18,2,25,68,34,28,10,62
2022/2023,2º TURNO,Flamengo,83,22,10,32,9,24,10,34,19,6,21,0,20,94,34,24,10,58,Paulistano,70,19,7,26,11,15,12,27,9,10,14,3,16,63,38,21,20,59
2022/2023,2º TURNO,Pinheiros,89,16,11,27,24,23,15,38,16,8,23,4,21,86,32,36,29,68,Caxias do Sul Basquete,82,19,9,28,17,27,12,39,16,12,29,2,29,81,36,30,20,66
2022/2023,2º TURNO,Caxias do Sul Basquete,55,15,7,22,4,27,7,34,11,12,16,2,17,55,29,28,12,57,UNIFACISA,58,16,7,23,5,31,10,41,8,6,19,1,14,58,40,19,6,59
2022/2023,2º TURNO,BRB/Brasília,74,16,9,25,15,28,14,42,19,5,15,3,22,73,38,32,25,70,Rio Claro,92,25,9,34,15,34,12,46,19,8,9,0,24,113,43,28,21,71
2022/2023,2º TURNO,Corinthians,75,17,7,24,20,25,11,36,15,8,13,5,20,83,32,28,27,60,Caxias do Sul Basquete,76,18,8,26,16,25,10,35,15,6,19,2,25,75,36,23,23,59
2022/2023,2º TURNO,BRB/Brasília,72,15,9,24,15,29,4,33,19,8,19,0,20,76,27,29,20,56,Sesi Franca,87,20,11,31,14,29,12,41,19,12,12,2,21,103,41,29,21,70
2022/2023,2º TURNO,123 Minas,105,26,12,38,17,29,8,37,21,8,13,0,15,133,38,20,22,58,Paulistano,70,21,6,27,10,15,14,29,14,3,14,0,25,57,47,22,13,69
2022/2023,2º TURNO,União Corinthians,82,19,12,31,8,32,5,37,17,3,15,3,24,85,33,34,14,67,UNIFACISA,85,16,11,27,20,32,10,42,14,6,12,1,23,88,37,32,26,69
2022/2023,2º TURNO,Sesi Franca,95,22,8,30,27,35,9,44,19,4,15,4,19,111,41,22,34,63,Oscar São José Basketball,75,21,8,29,9,28,14,42,19,8,14,4,30,80,44,28,20,72
2022/2023,2º TURNO,Flamengo,79,25,6,31,11,24,24,48,17,5,12,1,20,88,43,34,15,77,São Paulo,70,19,6,25,14,23,8,31,18,6,16,1,19,76,35,21,17,56
2022/2023,2º TURNO,123 Minas,82,22,8,30,14,28,7,35,22,4,17,1,20,92,34,27,18,61,Pato Basquete,90,25,10,35,10,26,12,38,24,11,10,2,22,108,43,30,19,73
2022/2023,2º TURNO,Oscar São José Basketball,97,19,13,32,20,30,16,46,24,5,14,7,22,127,37,28,25,65,São Paulo,84,16,13,29,13,18,6,24,19,8,11,3,20,89,32,30,18,62
2022/2023,2º TURNO,Bauru Basket,82,13,14,27,14,21,8,29,21,13,13,2,16,97,27,33,18,60,Pinheiros,71,22,6,28,9,28,11,39,17,7,18,2,23,82,37,19,17,56
2022/2023,2º TURNO,Cerrado,109,23,18,41,9,32,4,36,25,8,13,1,20,132,34,36,14,70,Rio Claro,84,20,9,29,17,27,13,40,17,5,16,1,18,83,44,30,20,74
2022/2023,2º TURNO,123 Minas,88,18,11,29,19,29,12,41,17,5,16,1,19,99,32,24,29,56,Corinthians,86,22,10,32,12,19,10,29,20,8,8,3,25,94,36,34,18,70
2022/2023,2º TURNO,Rio Claro,79,20,7,27,18,26,9,35,16,8,10,0,25,81,41,27,24,68,123 Minas,97,28,7,35,20,34,17,51,23,3,15,2,22,114,42,28,32,70
2022/2023,2º TURNO,Flamengo,96,23,14,37,8,31,9,40,27,3,8,1,15,127,39,29,9,68,Oscar São José Basketball,68,17,10,27,4,21,9,30,18,3,11,2,14,69,39,26,7,65
2022/2023,2º TURNO,União Corinthians,83,23,9,32,10,26,4,30,23,8,12,1,22,99,37,26,13,63,Sesi Franca,86,22,9,31,15,28,20,48,24,7,12,0,20,103,38,34,24,72
2022/2023,2º TURNO,Caxias do Sul Basquete,76,19,8,27,14,21,3,24,15,7,11,0,23,76,35,23,18,58,Sesi Franca,89,25,7,32,18,30,12,42,18,3,12,2,22,107,38,26,21,64
2022/2023,2º TURNO,Corinthians,82,16,12,28,14,29,13,42,21,5,18,2,22,89,28,35,24,63,União Corinthians,78,16,9,25,19,26,7,33,17,10,12,3,26,87,35,26,25,61
2022/2023,2º TURNO,Fortaleza B. C.,78,18,8,26,18,23,5,28,15,9,11,0,28,77,40,19,27,59,Pinheiros,92,16,14,30,18,33,7,40,22,5,16,1,22,104,30,26,32,56
2022/2023,2º TURNO,UNIFACISA,71,13,9,22,18,22,11,33,12,1,12,0,16,68,34,21,22,55,Bauru Basket,81,19,12,31,7,23,3,26,13,8,10,2,22,92,26,30,10,56
2022/2023,2º TURNO,BRB/Brasília,75,9,15,24,12,23,9,32,17,7,22,1,25,69,22,33,22,55,Flamengo,109,27,12,39,19,27,9,36,28,10,9,5,22,144,42,27,24,69
2022/2023,2º TURNO,Oscar São José Basketball,71,19,7,26,12,25,8,33,20,2,13,0,26,77,31,30,13,61,Paulistano,77,15,8,23,23,25,22,47,10,11,9,0,21,84,41,29,28,70
2022/2023,2º TURNO,Fortaleza B. C.,79,20,8,28,15,32,9,41,7,6,9,0,16,80,39,21,27,60,Bauru Basket,77,19,9,28,12,25,5,30,18,3,8,1,24,82,31,34,14,65
2022/2023,2º TURNO,Pato Basquete,66,25,3,28,7,30,11,41,12,4,13,1,16,76,41,21,8,62,União Corinthians,68,13,11,24,9,22,6,28,13,3,10,1,14,67,26,33,10,59
2022/2023,2º TURNO,Cerrado,70,13,12,25,8,26,7,33,9,6,14,3,17,63,25,38,14,63,Flamengo,102,26,12,38,14,34,6,40,24,8,8,0,17,131,37,29,21,66
2022/2023,2º TURNO,UNIFACISA,69,15,7,22,18,23,3,26,16,10,18,1,19,66,32,20,26,52,Pinheiros,80,21,9,30,11,29,13,42,16,5,19,2,27,85,44,21,17,65
2022/2023,2º TURNO,Sesi Franca,94,21,12,33,16,27,11,38,22,3,9,3,15,107,42,25,26,67,123 Minas,90,21,12,33,12,28,12,40,17,7,9,3,21,106,37,37,13,74
2022/2023,2º TURNO,123 Minas,87,18,11,29,18,33,9,42,22,5,16,1,23,106,32,26,24,58,São Paulo,76,17,8,25,18,23,7,30,11,4,12,0,19,63,37,28,24,65
2022/2023,2º TURNO,União Corinthians,95,17,10,27,31,32,11,43,17,11,13,5,25,111,36,31,38,67,Rio Claro,83,18,9,27,20,30,17,47,14,7,18,1,32,84,41,34,22,75
2022/2023,2º TURNO,Paulistano,91,30,7,37,10,26,16,42,17,10,16,1,21,105,53,22,12,75,Cerrado,77,18,9,27,14,22,5,27,19,8,22,2,14,76,29,25,22,54
2022/2023,2º TURNO,Bauru Basket,74,16,12,28,6,25,10,35,24,4,12,2,16,95,26,33,7,59,Pato Basquete,55,17,4,21,9,19,14,33,8,6,13,3,14,52,39,19,12,58
2022/2023,2º TURNO,Pinheiros,78,29,3,32,11,30,12,42,22,14,10,2,18,105,52,20,14,72,Corinthians,69,8,12,20,17,28,9,37,14,5,18,2,14,66,25,31,24,56
2022/2023,2º TURNO,Caxias do Sul Basquete,76,19,10,29,8,35,6,41,15,9,17,5,21,95,33,26,12,59,Rio Claro,53,15,3,18,14,26,8,34,15,6,15,0,20,47,40,20,18,60
2022/2023,2º TURNO,São Paulo,88,23,10,33,12,30,11,41,19,8,14,2,18,107,39,27,16,66,BRB/Brasília,72,15,10,25,12,24,10,34,18,2,15,2,22,70,35,29,16,64
2022/2023,2º TURNO,Bauru Basket,75,17,10,27,11,25,6,31,12,10,9,1,21,80,41,24,13,65,Corinthians,63,20,5,25,8,33,8,41,10,5,23,5,21,66,36,21,11,57
2022/2023,2º TURNO,Paulistano,82,21,7,28,19,31,14,45,16,9,12,3,21,97,47,23,23,70,União Corinthians,80,19,9,28,15,30,10,40,17,6,12,5,20,92,41,25,21,66
2022/2023,2º TURNO,Pinheiros,76,19,8,27,14,26,18,44,21,6,15,0,17,86,45,25,17,70,Pato Basquete,69,16,9,25,10,25,8,33,18,8,19,4,22,75,31,28,14,59
2022/2023,2º TURNO,São Paulo,99,21,14,35,15,30,12,42,19,4,11,0,13,115,34,37,17,71,União Corinthians,76,18,11,29,7,24,7,31,16,5,13,2,13,77,29,37,10,66
2022/2023,2º TURNO,Cerrado,64,21,5,26,7,25,7,32,15,7,21,1,12,62,35,22,12,57,Oscar São José Basketball,96,29,10,39,8,28,12,40,22,12,9,2,18,125,49,24,12,73
2022/2023,2º TURNO,Rio Claro,84,21,9,30,15,23,6,29,12,9,10,0,26,91,37,24,17,61,Bauru Basket,69,14,6,20,23,26,3,29,8,5,20,1,18,65,17,24,29,41
2022/2023,2º TURNO,Paulistano,83,16,13,29,12,33,19,52,17,8,19,3,22,102,37,29,17,66,Caxias do Sul Basquete,58,13,6,19,14,20,8,28,10,9,17,1,19,46,38,17,21,55
2022/2023,2º TURNO,Pato Basquete,82,24,6,30,16,26,13,39,17,5,16,0,19,94,42,19,18,61,UNIFACISA,71,14,11,25,10,17,13,30,12,6,13,2,22,67,28,35,13,63
2022/2023,2º TURNO,BRB/Brasília,94,16,12,28,26,21,17,38,15,5,21,3,28,93,37,27,31,64,Oscar São José Basketball,100,30,4,34,28,22,10,32,18,11,12,2,23,116,44,19,34,63
2022/2023,2º TURNO,São Paulo,70,13,10,23,14,31,10,41,22,7,17,0,17,75,25,34,26,59,Caxias do Sul Basquete,64,19,6,25,8,29,13,42,12,7,15,1,22,61,38,31,14,69
2022/2023,2º TURNO,Corinthians,84,16,11,27,19,36,15,51,17,4,15,4,28,89,31,37,34,68,Fortaleza B. C.,85,25,5,30,20,27,13,40,11,8,10,1,24,83,44,25,33,69
2022/2023,2º TURNO,União Corinthians,78,19,10,29,10,27,13,40,19,5,10,3,20,93,35,35,11,70,Flamengo,77,14,12,26,13,29,14,43,17,6,13,1,17,89,32,34,15,66
2022/2023,2º TURNO,Rio Claro,82,17,11,28,15,21,6,27,14,4,11,0,23,81,32,26,20,58,Pinheiros,99,25,10,35,19,26,10,36,19,6,10,0,20,112,36,23,33,59
2022/2023,2º TURNO,BRB/Brasília,86,25,7,32,15,31,12,43,17,10,17,3,23,102,39,25,23,64,Cerrado,65,16,5,21,18,25,5,30,6,9,17,1,22,52,25,33,23,58
2022/2023,2º TURNO,Corinthians,66,21,4,25,12,33,13,46,15,3,18,8,23,78,39,19,21,58,UNIFACISA,68,14,9,23,13,27,6,33,16,9,11,3,24,74,34,23,23,57
2022/2023,2º TURNO,Pato Basquete,82,24,8,32,10,33,19,52,9,3,11,0,24,78,47,33,19,80,Fortaleza B. C.,87,17,11,28,20,31,4,35,9,6,10,0,20,85,32,29,29,61
2022/2023,2º TURNO,Bauru Basket,74,15,9,24,17,23,8,31,20,3,9,0,18,77,30,30,23,60,São Paulo,81,17,11,28,14,29,5,34,15,5,12,1,20,95,28,27,16,55
2022/2023,2º TURNO,Sesi Franca,95,20,12,32,19,30,7,37,21,6,9,3,18,115,36,31,22,67,Pinheiros,75,19,8,27,13,29,13,42,23,5,11,0,21,84,44,26,20,70
2022/2023,2º TURNO,Flamengo,79,14,12,26,15,30,5,35,24,7,19,4,19,98,27,30,16,57,123 Minas,78,21,8,29,12,26,9,35,14,10,15,2,22,82,44,23,16,67
2022/2023,2º TURNO,Sesi Franca,90,17,8,25,32,26,8,34,17,2,14,2,16,102,32,20,34,52,Bauru Basket,82,17,15,32,3,17,10,27,14,6,11,3,27,82,32,37,5,69
2022/2023,2º TURNO,São Paulo,79,22,7,29,14,20,8,28,12,10,12,4,17,79,35,29,21,64,UNIFACISA,99,23,12,35,17,32,9,41,14,5,16,1,19,113,34,31,18,65
2022/2023,2º TURNO,123 Minas,110,24,19,43,5,28,10,38,30,5,16,0,17,137,37,32,9,69,BRB/Brasília,79,24,7,31,10,20,11,31,21,10,13,1,14,87,50,18,15,68
2022/2023,2º TURNO,Fortaleza B. C.,75,12,13,25,12,24,6,30,12,7,16,2,22,69,29,27,22,56,Rio Claro,99,28,10,38,13,31,4,35,30,8,12,0,23,131,37,23,20,60
2022/2023,2º TURNO,União Corinthians,80,15,14,29,8,26,7,33,20,14,7,2,17,97,34,33,15,67,Oscar São José Basketball,68,21,6,27,8,34,10,44,19,0,18,1,16,75,42,18,14,60
2022/2023,2º TURNO,Caxias do Sul Basquete,71,19,5,24,18,23,7,30,10,7,12,2,22,66,44,20,20,64,Flamengo,82,21,8,29,16,32,15,47,15,5,19,3,18,93,35,30,20,65
2022/2023,2º TURNO,Corinthians,102,28,11,39,13,33,11,44,25,3,10,2,14,131,40,28,19,68,Pato Basquete,78,18,9,27,15,21,9,30,18,6,6,0,17,80,40,28,20,68
2022/2023,2º TURNO,123 Minas,99,26,12,38,11,34,9,43,34,9,11,1,16,138,45,26,15,71,Cerrado,70,16,11,27,5,25,12,37,14,7,16,2,11,62,36,33,15,69
2022/2023,2º TURNO,Fortaleza B. C.,65,14,9,23,10,19,11,30,14,3,13,1,19,56,34,31,12,65,Sesi Franca,102,29,12,41,8,32,10,42,25,6,9,2,17,135,40,27,15,67
2022/2023,2º TURNO,Caxias do Sul Basquete,79,20,9,29,12,24,11,35,11,5,19,1,18,76,38,21,18,59,Oscar São José Basketball,76,24,6,30,10,23,6,29,17,8,15,3,23,86,38,20,14,58
2022/2023,2º TURNO,Pinheiros,67,13,10,23,11,32,10,42,18,7,26,1,24,70,28,25,20,53,Paulistano,74,23,5,28,13,22,11,33,12,10,13,1,21,70,39,27,22,66
2022/2023,2º TURNO,Flamengo,66,22,5,27,7,31,6,37,16,6,13,3,14,89,31,20,9,51,Bauru Basket,54,7,12,19,4,19,6,25,17,7,9,0,15,56,27,28,6,55
2022/2023,2º TURNO,UNIFACISA,84,21,9,30,15,26,14,40,15,4,12,1,17,94,37,26,20,63,Rio Claro,78,23,8,31,8,21,6,27,20,4,11,2,23,86,39,22,12,61
2022/2023,2º TURNO,UNIFACISA,80,18,11,29,11,37,18,55,14,7,17,4,25,89,43,38,13,81,Sesi Franca,83,19,11,30,12,33,11,44,17,7,13,3,16,90,40,37,16,77
2022/2023,2º TURNO,União Corinthians,78,18,12,30,6,26,11,37,18,4,10,2,27,81,29,45,10,74,123 Minas,82,20,6,26,24,34,8,42,17,6,13,3,17,97,35,21,34,56
2022/2023,2º TURNO,Bauru Basket,80,19,9,28,15,26,9,35,14,12,12,1,18,95,33,27,18,60,Paulistano,70,15,10,25,10,25,12,37,13,9,16,0,20,73,38,23,14,61
2022/2023,2º TURNO,Caxias do Sul Basquete,80,15,14,29,8,33,8,41,19,6,10,6,23,102,34,33,10,67,123 Minas,63,16,4,20,19,31,8,39,13,6,12,1,14,67,34,25,23,59
2022/2023,2º TURNO,Sesi Franca,103,26,11,37,18,25,10,35,25,10,12,1,16,127,45,22,23,67,Corinthians,92,25,11,36,9,22,6,28,17,2,14,1,22,94,38,25,14,63
2022/2023,2º TURNO,Paulistano,85,25,9,34,8,32,7,39,25,7,10,2,19,106,47,20,17,67,UNIFACISA,68,15,10,25,8,30,6,36,16,4,14,2,21,70,35,26,14,61
2022/2023,2º TURNO,Rio Claro,77,24,4,28,17,16,12,28,16,11,11,0,23,69,51,24,22,75,Corinthians,97,25,9,34,20,38,6,44,19,5,21,2,21,121,34,21,24,55
2022/2023,2º TURNO,Pato Basquete,88,21,10,31,16,31,8,39,14,10,17,4,25,98,38,25,24,63,Caxias do Sul Basquete,80,15,9,24,23,29,10,39,18,6,15,1,20,82,32,34,28,66
2022/2023,2º TURNO,Oscar São José Basketball,94,23,11,34,15,22,6,28,29,9,9,1,21,118,34,29,20,63,Pinheiros,92,25,10,35,12,26,16,42,22,3,12,0,21,105,41,31,17,72
2022/2023,2º TURNO,BRB/Brasília,78,19,8,27,16,29,14,43,17,4,19,0,25,82,42,25,17,67,Caxias do Sul Basquete,88,15,13,28,19,27,6,33,16,4,14,1,19,86,31,26,32,57
2022/2023,2º TURNO,Paulistano,80,19,10,29,12,25,8,33,17,6,8,0,26,87,36,29,17,65,Fortaleza B. C.,78,14,10,24,20,32,10,42,13,3,15,0,22,82,33,24,26,57
2022/2023,2º TURNO,Sesi Franca,88,23,10,33,12,30,6,36,26,7,20,2,23,110,29,29,16,58,Pato Basquete,82,19,7,26,23,21,17,38,12,12,14,1,16,77,39,29,35,68
2022/2023,2º TURNO,BRB/Brasília,74,18,8,26,14,30,8,38,21,4,16,1,11,75,39,24,24,63,União Corinthians,96,20,17,37,5,35,9,44,18,12,12,2,17,120,35,39,8,74
2022/2023,2º TURNO,São Paulo,85,18,11,29,16,29,4,33,22,7,14,2,23,101,25,34,20,59,Fortaleza B. C.,70,18,6,24,16,26,17,43,8,8,13,3,20,70,33,33,23,66
2022/2023,2º TURNO,Oscar São José Basketball,66,17,7,24,11,21,9,30,14,11,7,2,19,66,37,33,15,70,Bauru Basket,93,19,14,33,13,40,4,44,21,4,14,2,15,120,27,30,19,57
2022/2023,2º TURNO,Cerrado,99,22,13,35,16,37,22,59,18,4,13,3,17,110,47,41,23,88,União Corinthians,107,13,18,31,27,33,10,43,19,8,11,7,18,125,36,40,30,76
2022/2023,2º TURNO,Rio Claro,100,25,10,35,20,22,4,26,20,6,11,2,23,115,34,21,28,55,Pato Basquete,93,22,10,32,19,20,15,35,13,7,11,1,26,96,36,32,25,68
2022/2023,2º TURNO,UNIFACISA,78,18,9,27,15,25,9,34,14,7,11,1,25,75,38,29,23,67,Flamengo,80,19,9,28,15,34,13,47,13,5,16,2,21,86,36,28,24,64
2022/2023,2º TURNO,Paulistano,81,20,9,29,14,26,11,37,12,3,8,1,18,83,46,21,19,67,Corinthians,82,18,13,31,7,30,14,44,16,5,9,2,20,95,44,28,11,72
2022/2023,2º TURNO,Fortaleza B. C.,64,17,6,23,12,24,13,37,9,4,10,0,18,51,44,28,16,72,Flamengo,99,16,17,33,16,37,11,48,28,5,11,1,15,131,25,44,19,69
2022/2023,2º TURNO,Cerrado,91,9,17,26,22,25,7,32,21,2,14,0,21,91,20,36,33,56,Caxias do Sul Basquete,98,24,9,33,23,26,9,35,19,7,8,1,23,114,44,20,30,64
2022/2023,2º TURNO,Oscar São José Basketball,89,21,13,34,8,17,10,27,23,2,7,2,16,101,35,34,8,69,123 Minas,96,28,10,38,10,25,14,39,21,3,10,2,13,118,47,23,11,70
2022/2023,2º TURNO,Pinheiros,79,22,6,28,17,26,11,37,21,7,11,1,18,85,41,25,28,66,São Paulo,89,17,13,30,16,31,9,40,19,6,14,2,22,105,30,33,20,63
2022/2023,2º TURNO,UNIFACISA,79,12,13,25,16,19,12,31,17,5,6,1,20,78,32,36,22,68,Oscar São José Basketball,88,21,11,32,13,33,4,37,22,3,12,4,20,116,30,23,18,53
2022/2023,2º TURNO,Sesi Franca,95,18,14,32,17,24,20,44,17,10,11,6,14,117,37,36,20,73,Rio Claro,73,18,11,29,4,22,13,35,21,3,19,2,21,72,40,26,10,66
2022/2023,2º TURNO,Flamengo,90,16,18,34,4,28,13,41,22,10,11,3,10,113,39,30,11,69,Corinthians,64,17,9,26,3,24,8,32,18,5,15,2,17,68,39,23,5,62
2022/2023,2º TURNO,Pinheiros,94,23,10,33,18,34,18,52,23,10,12,2,26,120,50,27,23,77,BRB/Brasília,83,11,12,23,25,29,8,37,16,6,14,2,20,82,24,36,36,60
2022/2023,2º TURNO,Bauru Basket,97,30,8,38,13,32,12,44,33,7,7,6,14,140,49,25,17,74,Cerrado,73,13,11,24,14,24,3,27,13,5,13,2,11,68,29,30,18,59
2022/2023,2º TURNO,Corinthians,73,16,7,23,20,22,14,36,18,8,14,2,20,77,38,27,24,65,São Paulo,85,21,10,31,13,28,12,40,15,5,16,2,21,89,37,28,21,65
2022/2023,2º TURNO,Pato Basquete,75,25,5,30,10,23,10,33,9,9,15,1,21,73,46,21,12,67,Paulistano,87,22,8,30,19,28,11,39,10,7,14,0,16,92,36,27,23,63
2022/2023,2º TURNO,União Corinthians,72,15,9,24,15,33,14,47,16,9,9,4,22,79,35,40,24,75,Caxias do Sul Basquete,74,19,6,25,18,37,6,43,11,5,12,2,23,82,42,17,25,59
2022/2023,2º TURNO,Bauru Basket,72,17,8,25,14,29,8,37,18,7,14,2,17,86,37,23,15,60,BRB/Brasília,70,18,9,27,7,27,13,40,17,10,16,1,19,80,37,28,11,65
2022/2023,2º TURNO,Fortaleza B. C.,71,17,10,27,7,21,13,34,16,5,13,1,20,67,37,31,13,68,Oscar São José Basketball,90,23,10,33,14,31,12,43,22,6,10,4,16,117,39,24,22,63
2022/2023,2º TURNO,Pinheiros,95,27,11,38,8,32,16,48,23,11,14,1,14,119,49,30,12,79,Cerrado,65,17,9,26,4,24,6,30,14,6,20,3,10,58,27,35,8,62
2022/2023,2º TURNO,Cerrado,73,13,8,21,23,32,6,38,15,4,21,2,13,75,31,25,24,56,UNIFACISA,83,25,8,33,9,29,9,38,22,13,14,4,20,104,44,29,11,73
2022/2023,2º TURNO,Pato Basquete,69,22,6,28,7,24,18,42,13,8,15,2,18,68,44,30,12,74,São Paulo,84,17,12,29,14,27,10,37,20,8,15,3,18,99,34,29,18,63
2022/2023,2º TURNO,Paulistano,76,24,3,27,19,28,21,49,12,4,9,2,21,85,47,25,23,72,Rio Claro,66,17,7,24,11,25,12,37,15,6,12,1,24,69,39,22,18,61
2022/2023,2º TURNO,Oscar São José Basketball,88,22,10,32,14,20,16,36,20,14,11,1,22,102,49,26,17,75,Corinthians,81,22,7,29,16,25,7,32,20,6,22,6,19,92,34,19,23,53
2022/2023,2º TURNO,123 Minas,74,12,11,23,17,28,14,42,24,5,13,2,20,90,31,30,23,61,Pinheiros,67,8,12,20,15,28,16,44,21,7,16,1,23,74,29,33,23,62
2022/2023,2º TURNO,Cerrado,88,19,15,34,5,33,15,48,18,6,12,3,15,107,36,35,12,71,Fortaleza B. C.,68,22,6,28,6,28,19,47,12,9,9,3,17,74,46,30,14,76
2022/2023,2º TURNO,BRB/Brasília,88,16,15,31,11,23,6,29,15,6,8,1,15,87,38,34,14,72,UNIFACISA,101,25,14,39,9,37,10,47,23,4,12,4,19,132,38,33,12,71
2022/2023,2º TURNO,Flamengo,70,9,13,22,13,30,11,41,17,3,13,3,16,77,18,41,20,59,Pinheiros,66,20,6,26,8,28,10,38,16,7,11,2,20,77,39,24,12,63
2022/2023,2º TURNO,Oscar São José Basketball,96,28,11,39,7,27,7,34,26,12,18,4,14,128,39,22,11,61,Pato Basquete,69,20,8,28,5,17,16,33,13,13,18,1,11,62,46,23,13,69
2022/2023,2º TURNO,São Paulo,92,21,13,34,11,25,5,30,27,11,13,1,18,119,33,27,14,60,Rio Claro,76,22,8,30,8,22,9,31,22,5,18,0,19,80,42,22,10,64
2022/2023,2º TURNO,123 Minas,63,19,3,22,16,33,8,41,14,6,13,2,19,74,39,17,21,56,Bauru Basket,58,16,7,23,5,27,5,32,19,8,13,1,21,61,33,26,13,59
2022/2023,2º TURNO,Paulistano,64,15,7,22,13,27,16,43,11,8,11,5,21,62,49,26,18,75,Sesi Franca,70,16,5,21,23,35,11,46,9,5,17,4,17,77,38,20,26,58
2022/2023,2º TURNO,BRB/Brasília,80,15,11,26,17,20,11,31,12,5,15,3,19,76,25,38,20,63,Fortaleza B. C.,82,18,10,28,16,26,6,32,17,7,18,3,19,92,33,21,21,54
2022/2023,2º TURNO,Flamengo,89,27,11,38,2,24,17,41,27,8,8,2,14,119,39,37,4,76,Pato Basquete,75,24,8,32,3,22,9,31,16,5,13,0,16,80,44,18,7,62
2022/2023,1º TURNO,Caxias do Sul Basquete,69,16,7,23,16,31,14,45,8,9,17,2,20,64,41,28,22,69,Pinheiros,77,14,10,24,19,34,11,45,10,7,20,4,25,79,37,27,23,64
2022/2023,1º TURNO,Caxias do Sul Basquete,61,16,3,19,20,25,4,29,5,6,11,3,17,61,33,15,23,48,Bauru Basket,74,19,9,28,9,26,12,38,20,6,9,3,18,91,30,31,17,61
2022/2023,2º TURNO,São Paulo,102,25,14,39,10,23,8,31,24,9,8,0,31,109,42,39,17,81,Sesi Franca,105,21,11,32,30,38,12,50,15,6,18,3,23,122,36,28,37,64
2022/2023,1º TURNO,123 Minas,88,17,16,33,6,28,7,35,21,5,16,2,19,98,32,30,14,62,UNIFACISA,87,22,11,33,10,25,20,45,13,9,14,1,17,91,44,36,13,80
2022/2023,1º TURNO,União Corinthians,70,15,8,23,16,30,16,46,15,9,18,1,23,71,35,32,24,67,Pinheiros,79,24,6,30,13,30,17,47,18,9,16,2,21,89,45,26,22,71
2022/2023,1º TURNO,Cerrado,109,19,18,37,17,19,12,31,22,6,12,3,15,119,33,38,23,71,Pato Basquete,110,27,14,41,14,23,9,32,20,6,15,1,20,121,47,22,19,69
2022/2023,1º TURNO,BRB/Brasília,88,22,11,33,11,22,10,32,23,3,7,4,22,92,50,28,17,78,Corinthians,101,29,9,38,16,35,14,49,18,2,10,1,21,121,49,24,21,73
2022/2023,1º TURNO,União Corinthians,67,13,8,21,17,27,7,34,14,6,17,1,19,68,27,29,19,56,Bauru Basket,79,14,12,26,15,29,7,36,19,9,14,1,21,93,29,30,19,59
2022/2023,1º TURNO,Cerrado,89,22,12,34,9,32,12,44,18,9,14,2,16,100,41,36,14,77,Corinthians,79,20,9,29,12,32,9,41,15,6,17,5,20,87,39,30,14,69
2022/2023,1º TURNO,Fortaleza B. C.,88,21,11,32,13,35,18,53,17,6,12,1,20,98,44,29,27,73,UNIFACISA,79,20,9,29,12,29,7,36,11,7,11,2,26,81,40,29,15,69
2022/2023,1º TURNO,Oscar São José Basketball,98,22,12,34,18,30,10,40,23,9,13,3,19,131,36,22,23,58,Rio Claro,63,20,5,25,8,17,11,28,14,3,12,4,19,55,46,20,12,66
2022/2023,1º TURNO,BRB/Brasília,79,26,6,32,9,34,8,42,21,8,20,2,19,99,35,25,14,60,Pato Basquete,66,19,4,23,16,22,4,26,10,7,16,1,17,55,34,26,18,60
2022/2023,1º TURNO,Flamengo,59,10,10,20,9,26,15,41,10,5,10,3,12,57,25,42,13,67,Sesi Franca,69,16,10,26,7,33,10,43,14,6,11,0,19,82,38,26,8,64
2022/2023,1º TURNO,Flamengo,110,20,22,42,4,32,12,44,33,9,8,2,10,161,32,37,6,69,Rio Claro,57,13,9,22,4,17,6,23,15,5,13,4,12,52,32,26,7,58
2022/2023,1º TURNO,Fortaleza B. C.,84,23,9,32,11,30,16,46,17,7,21,2,24,97,43,22,16,65,Caxias do Sul Basquete,73,21,4,25,19,19,10,29,10,12,16,2,21,67,39,21,27,60
2022/2023,1º TURNO,São Paulo,100,15,19,34,13,23,3,26,26,11,7,0,21,122,30,34,17,64,123 Minas,83,22,9,31,12,28,13,41,21,4,13,1,18,96,38,29,17,67
2022/2023,1º TURNO,Oscar São José Basketball,73,18,8,26,13,18,9,27,15,9,8,3,22,80,40,22,16,62,Sesi Franca,83,14,12,26,19,29,7,36,18,3,16,3,19,100,24,27,21,51
2022/2023,1º TURNO,Pinheiros,68,20,5,25,13,27,14,41,9,8,14,4,17,71,43,18,22,61,Bauru Basket,65,8,11,19,16,26,13,39,15,9,16,4,21,72,25,34,20,59
2022/2023,1º TURNO,São Paulo,96,25,11,36,13,32,12,44,19,9,11,3,18,124,41,27,17,68,Oscar São José Basketball,68,19,7,26,9,23,14,37,17,6,13,3,18,66,43,26,18,69
2022/2023,1º TURNO,Rio Claro,93,31,7,38,10,15,10,25,23,16,7,3,21,116,52,16,17,68,Cerrado,90,21,13,34,9,22,15,37,10,4,21,1,14,88,30,32,14,62
2022/2023,1º TURNO,Paulistano,84,19,14,33,4,23,14,37,12,6,12,2,20,87,47,26,6,73,Flamengo,90,18,14,32,12,26,10,36,18,8,13,0,16,105,28,34,16,62
2022/2023,1º TURNO,Corinthians,77,19,4,23,27,30,8,38,14,5,18,3,13,88,34,16,31,50,Bauru Basket,72,21,7,28,9,20,6,26,15,8,9,0,24,75,38,27,9,65
2022/2023,1º TURNO,UNIFACISA,71,16,7,23,18,32,12,44,9,8,20,1,17,74,29,30,21,59,União Corinthians,66,10,13,23,7,25,5,30,18,10,15,1,21,72,26,31,11,57
2022/2023,1º TURNO,Pato Basquete,74,17,11,28,7,20,12,32,14,4,14,1,18,77,31,31,7,62,123 Minas,88,30,8,38,4,21,14,35,22,7,12,1,11,105,42,26,10,68
2022/2023,1º TURNO,Rio Claro,85,22,10,32,11,26,6,32,21,5,10,3,26,96,40,27,16,67,BRB/Brasília,87,24,7,31,18,32,11,43,19,6,17,2,21,97,45,20,27,65
2022/2023,1º TURNO,São Paulo,66,21,6,27,6,22,12,34,11,5,8,0,20,59,45,28,9,73,Flamengo,91,15,15,30,16,35,9,44,22,5,9,2,14,119,26,36,20,62
2022/2023,1º TURNO,Paulistano,72,26,4,30,8,30,13,43,16,10,12,5,15,90,49,23,10,72,Oscar São José Basketball,62,24,4,28,2,27,18,45,14,6,15,3,16,64,55,18,8,73
2022/2023,1º TURNO,Fortaleza B. C.,83,29,4,33,13,25,15,40,16,7,17,3,30,87,46,22,23,68,União Corinthians,94,23,9,32,21,24,12,36,18,11,14,2,24,103,36,26,35,62
2022/2023,1º TURNO,Corinthians,65,15,8,23,11,18,12,30,13,4,11,1,19,52,38,34,12,72,123 Minas,94,26,10,36,12,37,10,47,16,6,15,2,15,118,44,23,13,67
2022/2023,1º TURNO,UNIFACISA,63,14,8,22,11,26,13,39,15,6,13,1,14,69,35,26,14,61,Caxias do Sul Basquete,56,17,5,22,7,24,10,34,7,7,16,2,17,51,38,21,9,59
2022/2023,1º TURNO,Pato Basquete,85,18,14,32,7,17,6,23,18,4,18,0,25,82,29,27,13,56,Bauru Basket,96,16,13,29,25,19,4,23,15,10,14,2,18,110,23,26,27,49
2022/2023,1º TURNO,Bauru Basket,82,13,17,30,5,26,9,35,19,13,8,0,21,100,29,39,8,68,Fortaleza B. C.,50,8,6,14,16,30,9,39,9,3,23,2,17,43,30,15,22,45
2022/2023,1º TURNO,BRB/Brasília,89,17,10,27,25,28,12,40,17,5,18,3,22,94,31,27,36,58,São Paulo,96,12,19,31,15,23,12,35,20,12,13,2,31,107,27,40,24,67
2022/2023,1º TURNO,BRB/Brasília,72,20,8,28,8,35,9,44,7,2,11,1,17,69,41,26,15,67,Paulistano,82,18,14,32,4,33,12,45,17,9,7,2,23,100,46,33,5,79
2022/2023,1º TURNO,Cerrado,101,20,14,34,19,26,13,39,16,10,13,2,18,109,32,41,26,73,São Paulo,94,22,11,33,17,28,7,35,12,5,17,2,24,95,37,29,20,66
2022/2023,1º TURNO,Bauru Basket,68,11,12,23,10,22,9,31,15,5,11,0,19,67,25,36,13,61,UNIFACISA,76,15,11,26,13,30,7,37,13,7,13,1,16,88,28,27,17,55
2022/2023,1º TURNO,Pinheiros,100,28,10,38,14,28,13,41,25,5,7,2,18,125,38,35,20,73,UNIFACISA,86,12,15,27,17,25,9,34,17,1,9,0,20,90,29,35,19,64
2022/2023,1º TURNO,Pinheiros,95,24,12,36,11,28,10,38,25,14,14,6,20,124,43,28,16,71,Fortaleza B. C.,73,14,11,25,12,27,9,36,19,6,20,3,17,72,43,20,19,63
2022/2023,1º TURNO,Caxias do Sul Basquete,62,21,4,25,8,31,8,39,11,9,10,1,19,60,46,26,13,72,Corinthians,72,18,9,27,9,41,6,47,13,6,19,1,15,83,29,33,11,62
2022/2023,1º TURNO,Cerrado,80,16,14,30,6,30,11,41,13,5,20,2,20,79,32,35,11,67,Paulistano,93,27,7,34,18,27,7,34,19,8,10,1,16,106,49,21,21,70
2022/2023,1º TURNO,Caxias do Sul Basquete,73,20,7,27,12,31,12,43,16,6,17,4,18,82,36,27,19,63,Pato Basquete,84,18,11,29,15,26,10,36,14,14,11,2,15,94,41,26,22,67
2022/2023,1º TURNO,UNIFACISA,73,14,9,23,18,23,10,33,14,7,12,0,23,67,29,33,27,62,São Paulo,82,17,10,27,18,34,4,38,17,5,16,2,23,99,28,26,20,54
2022/2023,1º TURNO,União Corinthians,86,23,8,31,16,21,19,40,17,8,10,3,21,88,47,39,17,86,Corinthians,91,20,11,31,18,35,12,47,18,5,19,2,15,105,31,31,26,62
2022/2023,1º TURNO,Fortaleza B. C.,81,23,5,28,20,28,11,39,13,4,15,2,16,77,44,22,29,66,São Paulo,111,27,15,42,12,29,8,37,27,8,6,2,21,141,38,37,17,75
2022/2023,1º TURNO,Pinheiros,98,25,7,32,27,23,16,39,19,8,10,1,22,109,45,22,38,67,Oscar São José Basketball,90,16,12,28,22,24,11,35,24,3,14,1,26,101,36,25,27,61
2022/2023,1º TURNO,União Corinthians,85,14,12,26,21,25,13,38,24,11,16,2,23,100,26,37,28,63,Pato Basquete,93,22,12,34,13,26,10,36,19,7,15,1,23,102,38,26,22,64
2022/2023,1º TURNO,Oscar São José Basketball,74,21,8,29,8,32,6,38,18,2,9,1,18,82,37,32,10,69,Flamengo,84,15,14,29,12,36,8,44,14,6,8,0,16,97,32,37,15,69
2022/2023,1º TURNO,Rio Claro,74,19,7,26,15,21,13,34,12,9,13,1,20,72,36,28,22,64,União Corinthians,81,17,11,28,14,26,10,36,16,7,17,4,20,94,33,25,17,58
2022/2023,1º TURNO,Rio Claro,75,15,11,26,12,21,10,31,14,4,9,0,24,72,33,30,18,63,Caxias do Sul Basquete,83,16,11,27,18,31,4,35,18,3,11,1,18,100,26,25,23,51
2022/2023,1º TURNO,123 Minas,90,25,11,36,7,39,13,52,26,6,12,4,16,126,46,26,11,72,Rio Claro,61,14,8,22,9,25,8,33,16,9,10,4,18,62,43,25,14,68
2022/2023,1º TURNO,Corinthians,94,17,18,35,6,32,9,41,19,7,14,6,16,112,27,44,11,71,Pinheiros,70,19,6,25,14,27,17,44,11,6,16,0,17,63,52,21,18,73
2022/2023,1º TURNO,Sesi Franca,84,21,9,30,15,31,10,41,18,5,16,2,15,98,39,22,20,61,Caxias do Sul Basquete,83,25,7,32,12,22,8,30,11,10,12,1,17,83,43,24,17,67
2022/2023,1º TURNO,Paulistano,90,26,11,37,5,21,15,36,18,5,8,1,20,98,45,27,14,72,123 Minas,73,20,7,27,12,26,13,39,20,3,20,0,18,76,39,22,17,61
2022/2023,1º TURNO,Oscar São José Basketball,89,19,11,30,18,15,9,24,22,10,4,2,20,102,35,33,21,68,BRB/Brasília,94,25,11,36,11,29,12,41,20,3,19,1,17,110,38,22,17,60
2022/2023,1º TURNO,Sesi Franca,104,26,11,37,19,37,6,43,19,4,9,4,11,133,37,27,24,64,União Corinthians,65,14,11,25,4,23,12,35,16,7,13,3,18,63,28,46,5,74
2022/2023,1º TURNO,Oscar São José Basketball,88,20,11,31,15,36,7,43,25,3,14,4,15,112,37,28,18,65,Cerrado,79,14,13,27,12,27,14,41,19,7,13,1,18,81,30,44,18,74
2022/2023,1º TURNO,Caxias do Sul Basquete,66,18,7,25,9,25,10,35,7,9,8,1,15,66,41,23,14,64,Paulistano,63,15,9,24,6,29,8,37,11,2,15,1,18,63,31,25,10,56
2022/2023,1º TURNO,Pato Basquete,95,22,12,34,15,29,13,42,21,11,17,3,19,116,38,31,19,69,Pinheiros,76,24,6,30,10,23,14,37,14,10,18,3,20,73,46,24,19,70
2022/2023,1º TURNO,Flamengo,72,12,13,25,9,33,14,47,15,9,19,2,16,83,30,32,15,62,BRB/Brasília,50,10,7,17,9,26,9,35,15,8,18,1,18,45,29,30,13,59
2022/2023,1º TURNO,123 Minas,79,15,9,24,22,33,12,45,22,6,16,6,15,103,30,28,27,58,Fortaleza B. C.,71,25,5,30,6,24,10,34,17,7,11,3,22,77,47,25,8,72
2022/2023,1º TURNO,Flamengo,91,29,8,37,9,28,17,45,28,5,13,3,12,115,41,35,14,76,Cerrado Basquete,80,14,15,29,7,22,7,29,20,3,16,3,16,83,26,37,9,63
2022/2023,1º TURNO,Cerrado Basquete,88,15,12,27,22,28,7,35,20,8,18,0,21,93,28,29,32,57,BRB/Brasília,96,26,10,36,14,27,17,44,25,5,13,2,21,110,46,31,22,77
2022/2023,1º TURNO,União Corinthians,72,15,9,24,15,25,10,35,18,8,16,2,20,78,31,30,19,61,Paulistano,78,21,8,29,12,26,11,37,12,12,15,3,21,88,37,25,18,62
2022/2023,1º TURNO,Pinheiros,77,18,11,29,8,32,11,43,17,5,18,0,26,84,38,30,9,68,Sesi Franca,85,10,14,24,23,28,10,38,19,9,10,2,11,97,23,43,27,66
2022/2023,1º TURNO,123 Minas,104,26,14,40,10,37,16,53,28,15,7,3,15,152,44,35,15,79,Oscar São José Basketball,53,17,4,21,7,25,18,43,13,4,18,4,16,42,46,28,11,74
2022/2023,1º TURNO,Bauru Basket,92,26,9,35,13,33,10,43,17,7,9,1,18,120,36,24,19,60,Rio Claro,48,15,2,17,12,17,9,26,9,3,13,1,20,28,34,22,19,56
2022/2023,1º TURNO,UNIFACISA,76,18,9,27,13,19,9,28,16,8,14,0,17,74,36,26,18,62,Corinthians,92,19,15,34,9,28,6,34,15,9,20,3,17,105,31,28,12,59
2022/2023,1º TURNO,Fortaleza B. C.,77,27,5,32,8,29,19,48,10,14,7,1,26,77,59,28,19,87,Corinthians,81,15,10,25,21,42,11,53,13,5,23,3,18,87,27,31,33,58
2022/2023,1º TURNO,Caxias do Sul Basquete,70,13,9,22,17,31,6,37,14,4,11,2,16,65,39,26,25,65,São Paulo,86,20,12,32,10,38,12,50,21,6,12,3,18,109,40,33,14,73
2022/2023,1º TURNO,União Corinthians,71,14,11,25,10,23,2,25,18,4,11,2,22,73,32,26,13,58,São Paulo,93,21,11,32,18,33,3,36,14,3,8,1,19,111,38,20,20,58
2022/2023,1º TURNO,UNIFACISA,89,21,12,33,11,22,11,33,16,9,16,1,19,96,30,35,15,65,Pato Basquete,79,17,12,29,9,23,9,32,13,5,20,0,14,72,31,28,16,59
2022/2023,1º TURNO,Bauru Basket,78,21,9,30,9,23,6,29,16,5,8,0,17,83,34,26,16,60,Sesi Franca,88,22,11,33,11,27,5,32,19,5,6,1,18,106,43,18,16,61
2022/2023,1º TURNO,Pinheiros,86,20,10,30,16,31,13,44,20,7,18,2,22,99,35,27,26,62,Rio Claro,74,17,7,24,19,23,14,37,12,11,13,2,25,71,37,30,28,67
2022/2023,1º TURNO,Flamengo,79,19,10,29,11,30,8,38,22,12,11,1,11,102,30,33,16,63,União Corinthians,74,16,13,29,3,28,6,34,21,6,14,2,22,86,37,28,4,65
2022/2023,1º TURNO,Fortaleza B. C.,80,28,4,32,12,42,16,58,17,6,15,2,20,100,48,23,21,71,Pato Basquete,60,11,10,21,8,28,11,39,11,7,13,0,21,45,35,33,20,68
2022/2023,1º TURNO,Sesi Franca,106,17,14,31,30,32,8,40,12,3,11,0,20,120,30,24,37,54,UNIFACISA,94,14,17,31,15,19,12,31,15,8,6,1,28,94,33,39,23,72
2022/2023,1º TURNO,Oscar São José Basketball,103,28,11,39,14,32,9,41,26,3,12,2,15,132,43,25,16,68,União Corinthians,84,20,12,32,8,19,7,26,22,5,10,1,15,89,35,34,10,69
2022/2023,1º TURNO,BRB/Brasília,74,19,10,29,6,18,7,25,18,7,8,0,17,64,35,40,12,75,123 Minas,94,27,9,36,13,43,6,49,19,4,18,1,15,122,37,25,14,62
2022/2023,1º TURNO,Paulistano,71,21,6,27,11,25,27,52,10,10,10,4,20,82,50,29,14,79,Bauru Basket,68,15,10,25,8,25,14,39,8,5,17,4,13,65,33,31,11,64
2022/2023,1º TURNO,Flamengo,80,24,7,31,11,33,18,51,22,7,11,3,18,105,37,35,17,72,Caxias do Sul Basquete,69,13,10,23,13,25,6,31,10,6,9,3,23,66,31,31,18,62
2022/2023,1º TURNO,Pato Basquete,68,16,7,23,15,23,8,31,11,5,9,3,20,58,38,30,21,68,Corinthians,96,24,11,35,15,39,13,52,18,4,13,7,17,125,34,35,20,69
2022/2023,1º TURNO,Cerrado Basquete,102,13,18,31,22,23,10,33,13,7,15,1,22,96,27,45,26,72,123 Minas,112,30,12,42,16,33,17,50,20,9,18,3,27,133,48,33,20,81
2022/2023,1º TURNO,Oscar São José Basketball,78,21,8,29,12,28,7,35,22,4,14,4,20,93,31,27,19,58,Caxias do Sul Basquete,73,16,10,26,11,25,12,37,12,12,12,1,21,82,38,26,14,64
2022/2023,1º TURNO,São Paulo,82,22,10,32,8,27,10,37,18,8,10,0,12,96,38,27,14,65,Bauru Basket,73,18,10,28,7,24,11,35,24,4,13,2,16,84,29,37,10,66
2022/2023,1º TURNO,Rio Claro,104,21,16,37,14,26,9,35,23,7,6,1,22,124,33,36,22,69,UNIFACISA,80,20,8,28,16,28,13,41,10,4,17,2,23,79,40,25,20,65
2022/2023,1º TURNO,Paulistano,62,18,8,26,2,22,14,36,16,10,11,4,17,61,40,36,8,76,Pinheiros,76,22,7,29,11,36,9,45,23,8,17,2,15,102,41,19,15,60
2022/2023,1º TURNO,Caxias do Sul Basquete,86,23,9,32,13,23,14,37,15,10,16,2,23,97,35,28,19,63,BRB/Brasília,76,18,9,27,13,19,10,29,15,7,18,0,19,70,33,27,19,60
2022/2023,1º TURNO,Rio Claro,57,15,5,20,12,27,9,36,9,9,11,2,20,52,37,31,14,68,Fortaleza B. C.,72,17,10,27,8,39,7,46,16,5,18,2,20,84,31,28,15,59
2022/2023,1º TURNO,Pato Basquete,70,14,11,25,9,21,10,31,11,6,10,0,19,62,34,30,16,64,Sesi Franca,94,18,14,32,16,32,9,41,24,6,11,1,15,123,28,35,17,63
2022/2023,1º TURNO,123 Minas,81,22,9,31,10,29,9,38,20,5,12,2,12,102,37,23,13,60,União Corinthians,75,16,13,29,4,21,6,27,15,7,9,0,16,77,29,38,4,67
2022/2023,1º TURNO,Caxias do Sul Basquete,82,25,8,33,8,28,12,40,20,9,11,4,13,105,48,23,9,71,Cerrado Basquete,67,11,11,22,12,25,13,38,13,5,15,1,10,62,25,39,17,64
2022/2023,1º TURNO,São Paulo,78,20,10,30,8,21,11,32,17,10,15,1,23,87,33,28,13,61,Corinthians,72,11,9,20,23,23,9,32,12,10,16,3,17,77,27,25,27,52
2022/2023,1º TURNO,UNIFACISA,61,17,7,24,6,23,9,32,9,8,19,1,25,58,37,21,6,58,Paulistano,72,14,8,22,20,24,14,38,12,9,17,2,17,73,28,29,28,57
2022/2023,1º TURNO,Bauru Basket,94,24,10,34,16,22,8,30,17,6,12,4,19,108,33,27,21,60,Oscar São José Basketball,76,22,6,28,14,19,9,28,21,10,14,3,17,90,37,20,19,57
2022/2023,1º TURNO,União Corinthians,92,15,18,33,8,23,13,36,27,5,13,3,20,115,29,39,8,68,Cerrado Basquete,81,17,12,29,11,21,12,33,18,6,15,1,11,88,31,31,14,62
2022/2023,1º TURNO,Corinthians,82,27,6,33,10,29,6,35,17,7,13,4,21,94,44,24,13,68,Sesi Franca,85,23,7,30,18,26,19,45,23,7,10,3,20,101,45,29,26,74
2022/2023,1º TURNO,Pinheiros,65,19,7,26,6,31,11,42,18,6,13,4,16,74,42,25,13,67,Flamengo,74,13,14,27,6,33,10,43,16,6,14,3,18,87,32,36,6,68
2022/2023,1º TURNO,Fortaleza B. C.,55,15,4,19,13,30,14,44,9,6,17,4,15,53,41,24,15,65,Paulistano,78,23,8,31,8,33,12,45,17,10,9,3,17,98,45,28,12,73
2022/2023,1º TURNO,São Paulo,76,13,11,24,17,24,8,32,19,7,11,0,21,79,29,33,23,62,Pinheiros,72,18,8,26,12,33,15,48,20,6,18,3,21,87,39,25,18,64
2022/2023,1º TURNO,Bauru Basket,82,14,14,28,12,28,10,38,19,11,8,1,21,97,36,32,18,68,Flamengo,77,19,8,27,15,32,13,45,13,3,16,5,20,84,36,28,21,64
2022/2023,1º TURNO,União Corinthians,72,10,15,25,7,23,13,36,18,6,8,0,21,71,30,42,13,72,BRB/Brasília,74,14,11,25,13,34,5,39,11,3,18,0,22,78,29,23,17,52
2022/2023,1º TURNO,Pato Basquete,61,17,5,22,12,28,3,31,15,7,19,0,22,60,32,19,18,51,Rio Claro,59,19,4,23,9,30,9,39,11,7,19,1,18,54,43,14,19,57
2022/2023,1º TURNO,Oscar São José Basketball,62,16,8,24,6,24,8,32,16,6,11,0,20,67,29,31,8,60,UNIFACISA,71,20,7,27,10,29,9,38,11,5,11,1,19,77,41,20,14,61
2022/2023,1º TURNO,Sesi Franca,82,16,12,28,14,35,11,46,17,3,19,2,10,94,28,32,19,60,São Paulo,69,18,9,27,6,20,3,23,13,11,10,2,13,66,31,34,10,65
2022/2023,1º TURNO,Rio Claro,79,22,9,31,8,23,5,28,15,5,7,1,21,83,45,24,8,69,Sesi Franca,93,16,17,33,10,33,7,40,18,2,14,1,16,109,24,37,13,61
2022/2023,1º TURNO,Cerrado Basquete,69,14,8,22,17,32,10,42,8,3,19,8,19,72,23,33,22,56,Bauru Basket,80,24,5,29,17,25,17,42,17,7,5,1,20,89,56,21,22,77
2022/2023,1º TURNO,São Paulo,99,20,12,32,23,36,8,44,20,8,19,2,22,118,33,31,27,64,Pato Basquete,90,23,10,33,14,25,11,36,18,14,14,3,25,93,42,34,25,76
2022/2023,1º TURNO,Caxias do Sul Basquete,68,20,5,25,13,33,10,43,10,6,14,4,19,76,39,24,16,63,União Corinthians,65,12,11,23,8,28,5,33,13,7,16,2,19,65,36,24,10,60
2022/2023,1º TURNO,123 Minas,87,22,9,31,16,31,6,37,19,7,17,2,18,106,33,22,21,55,Caxias do Sul Basquete,81,18,9,27,18,17,12,29,14,5,9,1,17,74,38,28,26,66
2022/2023,1º TURNO,Oscar São José Basketball,83,11,17,28,10,36,6,42,20,5,10,4,16,107,26,38,11,64,Fortaleza B. C.,74,24,6,30,8,30,12,42,18,6,7,1,18,81,46,26,19,72
2022/2023,1º TURNO,Flamengo,91,15,16,31,13,38,16,54,25,7,12,3,16,127,29,39,17,68,UNIFACISA,53,14,5,19,10,23,7,30,9,7,11,2,20,45,42,20,12,62
2022/2023,1º TURNO,BRB/Brasília,66,11,11,22,11,21,11,32,14,7,15,0,21,67,22,33,15,55,Bauru Basket,86,20,10,30,16,23,10,33,17,7,8,0,19,101,30,30,20,60
2022/2023,1º TURNO,Corinthians,98,23,11,34,19,28,12,40,22,5,12,4,23,122,36,29,23,65,Rio Claro,77,25,1,26,24,21,23,44,11,7,9,3,24,77,61,12,33,73
2022/2023,1º TURNO,Corinthians,61,18,6,24,7,39,10,49,15,4,21,10,14,81,34,21,13,55,Paulistano,57,12,8,20,9,24,20,44,15,6,7,2,19,54,49,33,10,82
2022/2023,1º TURNO,Pato Basquete,64,18,6,24,10,24,9,33,9,5,10,0,18,60,34,28,13,62,Flamengo,91,15,15,30,16,30,8,38,18,3,10,0,16,108,25,37,16,62
2022/2023,1º TURNO,Bauru Basket,72,21,8,29,6,23,15,38,16,4,6,2,16,76,41,31,13,72,123 Minas,82,20,9,29,15,30,6,36,17,3,12,2,17,97,36,21,18,57
2022/2023,1º TURNO,Corinthians,70,18,6,24,16,24,14,38,15,5,19,4,21,76,33,24,20,57,Flamengo,82,16,13,29,11,20,11,31,19,7,17,1,20,84,26,34,19,60
